border_size=1
usage=map

Ww          , Ww          , Ww          , Ww          , Ds^Xo       , Ds          , Ds          , Gs^Fms      , Gs^Ft       , Gs^Ft       , Gs^Fms      , Ds          , Ggf         , Rd          , Gs^Fds      , Gs^Fds      , Gs^Fds      , Gs^Fms      , Gs^Fms      , Gs^Fms      , Gs^Fds      , Hh          , Hh^Fp       , Hh^Fp       , Hh^Fds      , Hh          , Hh          , Hh^Fp       , Hh^Fp       , Hh          , Hh^Fds      , Hh          
Ww          , Ww          , Ww          , Ww          , Ww          , Ds^Xo       , Ds^Xo       , Ds          , Ds          , Gs^Ft       , Gs^Ft       , Gs^Fms      , Ggf         , Rd          , Rd          , Gs^Fds      , Gg          , Gs^Fds      , Gg^Vh       , Gs^Fms      , Gs^Fds      , Gs^Fms      , Gs^Fms      , Hh^Fp       , Gs^Fds      , Hh^Fds      , Hh^Fds      , Hh          , Hh^Fds      , Hh^Fds      , Rd^Xo       , Hh^Fds      
Ww          , Ww          , Ww          , Ww          , Ww          , Ww          , Ww          , Ds^Xo       , Ds          , Gs^Fms      , Ds          , Re          , Gs^Ft       , Gg          , Ggf         , Rd          , Rd          , Gg^Vh       , Gg^Vl       , Gg^Vh       , Gg^Vh       , Gs^Fms      , Gs^Fds      , Gs^Fms      , Gs^Fds      , Gs^Fds      , Rd^Xo       , Rd^Xo       , Rd^Xo       , Rd^Xo       , Mm          , Rd^Xo       
Wo          , Ww          , Ww          , Ww          , Ww          , Ww          , Ww          , Ds^Xo       , Ds^Xo       , Ds          , Ds          , Gs^Fms      , Gs^Fms      , Gs^Fds      , Ggf         , Ggf         , Ggf         , Rd          , Rd          , Gg^Vh       , Gg          , Gs^Fds      , Ggf         , Gs^Fms      , Rd^Xo       , Rd^Xo       , Gs^Fds      , Gs^Fds      , Hh^Fds      , Mm          , Mm          , Mm          
Wo          , Wo          , Ww          , Ww          , Ww          , Ww          , Ww          , Ww          , Ww          , Ds^Xo       , Ds          , Gs^Ft       , Gs^Ft       , Gs^Fds      , Ggf         , Ggf         , Ggf         , Ggf         , Gg          , Rd          , Rd          , Rd          , Rd^Xo       , Rd^Xo       , Hh^Fp       , Hh^Fp       , Mm          , Hh^Fds      , Mm          , Mm          , Mm          , Mm          
Wo          , Wo          , Wo          , Ww          , Ww          , Ww          , Ww          , Ww          , Ww          , Ds^Xo       , Ds^Xo       , Gs^Fms      , Gs^Ft       , Gs^Fds      , Ggf         , Ggf         , Ggf         , Ggf         , Re^Xo       , Ggf^Xo      , Gg^Xo       , Ggf^Xo      , Gs^Fds      , Gs^Fds      , Mm          , Mm          , Mm          , Mm          , Mm          , Mm          , Hh^Fp       , Mm          
Wo          , Wo          , Wo          , Wo          , Ww          , Ww          , Ww          , Ww          , Ww          , Ww          , Ds^Xo       , Ds^Xo       , Re^Xo       , Gs^Ft       , Ggf^Xo      , Ggf^Xo      , Ggf^Xo      , Gg^Xo       , Re          , Re          , Re          , Gs^Fds      , Ggf         , Hh^Fds      , Co          , Ko          , Ko          , Mm          , Hh^Fms      , Hh^Fds      , Hh^Fp       , Hh          
Wo          , Wo          , Wo          , Wo          , Wo          , Ww          , Ww          , Ww          , Ww          , Ww          , Ww          , Gs^Ft       , Gs^Ft       , Re^Xo       , Ggf^Xo      , Gs^Fms      , Gg          , Re          , Ggf         , Ggf         , Gs^Fms      , Re          , Re          , Co          , Co          , Co          , Ko          , Mm          , Mm          , Hh          , Mm          , Mm          
Wo          , Wo          , Wo          , Wo          , Ww          , Ww          , Ww          , Ww          , Ww          , Ww          , Gs^Fds      , Gs^Fds      , Gs^Fds      , Gg^Xo       , Gg          , Gg          , Re          , Re          , Re          , Gg          , Gs^Fms      , Re          , Ggf         , Co          , Co          , Co          , Mm          , Mm          , Mm          , Mm          , Mm          , Mm          
Wo          , Wo          , Wo          , Wo          , Ww          , Ww          , Ww          , Ww          , Ww          , Ww          , Gs^Fds      , Gs^Fds      , Ss          , Gs^Fds      , Gg          , Ggf         , Re          , Re^Vct      , Re          , Re          , Re          , Re          , Gs^Fms      , Gg          , Hh^Fp       , Hh          , Mm          , Mm          , Mm          , Mm          , Mm          , Mm          
Wo          , Wo          , Ww          , Ww          , Ww          , Ww          , Ww          , Ww          , Gs^Fms      , Gs^Fds      , Ss          , Gs^Fms      , Ggf         , Gg          , Ggf         , Re          , Re          , Re          , Re          , Ggf         , Gs^Fms      , Ss          , Ss          , Hh^Fp       , Mm          , Hh^Fp       , Hh^Fds      , Mm          , Mm          , Mm          , Mm          , Mm          
Wo          , Wo          , Ww          , Ww          , Ww          , Ww          , Ww          , Ko          , Co          , Gs^Fms      , Gs^Fds      , Gs^Fms      , Gg          , Ss          , Gs^Fds      , Ggf         , Gg          , Re          , Ggf         , Gg          , Hh^Fp       , Hh^Fds      , Mm          , Mm          , Mm          , Mm          , Mm          , Hh^Fds      , Mm          , Mm          , Hh^Fp       , Mm          
Wo          , Wo          , Ww          , Ww          , Ww          , Ww          , Ww          , Co          , Co          , Co          , Gs^Fms      , Ss          , Ggf         , Gs^Fds      , Gg          , Gs^Fms      , Ggf         , Re          , Ggf         , Gs^Fms      , Hh^Fds      , Mm          , Mm          , Mm          , Mm          , Mm          , Mm          , Mm          , Mm          , Mm          , Mm          , Hh          
Wo          , Wo          , Ww          , Ww          , Ww          , Ww          , Ww          , Co          , Ss          , Ggf         , Ss          , Gs^Fms      , Gg          , Ggf         , Ss          , Gg          , Gg          , Re          , Re          , Gg          , Ss          , Ss          , Hh^Fp       , Hh^Fds      , Cud         , Ko          , Mm          , Mm          , Mm          , Mm          , Mm          , Mm          
Wo          , Wo          , Wo          , Ww          , Ww          , Ww          , Ww          , Gs^Fms      , Ss          , Gs^Fp       , Gs^Fms      , Ggf         , Ggf         , Gs^Vht      , Hh^Fds      , Gs^Fms      , Ss          , Gg          , Ggf         , Gs^Fms      , Ww          , Ww          , Ww          , Ww          , Wo          , Cud         , Hh          , Mm          , Mm          , Mm          , Mm          , Mm          
Wo          , Wo          , Wo          , Ww          , Ww          , Ww          , Ww          , Ww          , Ww          , Gs^Fp       , Ggf         , Ss          , Ggf         , Hh^Fds      , Hh^Fds      , Hh^Fp       , Gg          , Gg          , Gg^Vc       , Gg          , Ww          , Wo          , Wo          , Wo          , Wo          , Ww          , Ww          , Hh^Fp       , Hh^Fds      , Mm          , Mm          , Mm          
Wo          , Wo          , Wo          , Wo          , Ww          , Ww          , Ww          , Ww          , Ss          , Ggf         , Gs^Fds      , Gg          , Hh^Fds      , Hh          , Hh          , Ggf         , Gs^Fds      , Gs^Fms      , Gg          , Ww          , Wo          , Wo          , Wo          , Wo          , Wo          , Wo          , Ww          , Ww          , Hh^Fds      , Mm          , Mm          , Mm          
Wo          , Wo          , Wo          , Wo          , Ww          , Ww          , Ww          , Ww          , Ss          , Gs^Fp       , Gs^Fms      , Gg          , Gg          , Hh^Fp       , Ggf         , Gg          , Gg          , Ggf         , Ggf         , Ww          , Ww          , Wo          , Ww          , Ww          , Ww          , Wo          , Ww          , Hh          , Mm          , Mm          , Mm          , Mm          
Wo          , Wo          , Wo          , Wo          , Ww          , Ww          , Ww          , Ww          , Ww          , Gs^Vht      , Gg          , Ggf         , Gs^Fds      , Ggf         , Gs^Fds      , Gs^Fds      , Gs^Fds      , Gs^Fms      , Ggf         , Gs^Fms      , Ss          , Ww          , Hh          , Hh^Fp       , Hh^Fds      , Ww          , Ww          , Mm          , Mm          , Mm          , Mm          , Mm          
Wo          , Wo          , Wo          , Ww          , Ww          , Ww          , Ww          , Ww          , Ggf         , Gs^Fms      , Ggf         , Gs^Fms      , Gs^Fds      , Gg          , Ggf         , Gs^Fds      , Gs^Fms      , Gg          , Gs^Fms      , Gs^Fms      , Gs^Fp       , Gs^Fds      , Mm          , Mm          , Mm          , Mm          , Ww          , Mm          , Mm          , Mm          , Hh          , Mm          
Wo          , Wo          , Ww          , Ww          , Ww          , Ww          , Ww          , Ww          , Gs^Fp       , Gs^Fp       , Ss          , Gg          , Gs^Fms      , Ggf         , Re          , Gg          , Ss          , Ggf         , Ww          , Hh          , Ww          , Mm          , Mm          , Mm          , Mm          , Mm          , Ww          , Mm          , Hh          , Hh^Fp       , Mm          , Mm          
Wo          , Wo          , Wo          , Ww          , Ww          , Ww          , Ww          , Ww          , Ww          , Gs^Fp       , Ss          , Gg          , Ggf         , Gg          , Re          , Ss          , Ww          , Ww          , Gs^Fds      , Ww          , Mm          , Ww          , Ww          , Mm          , Ww          , Ww          , Ww          , Mm          , Mm          , Mm          , Mm          , Mm          
Wo          , Wo          , Ww          , Ww          , Ww          , Ww          , Ww          , Ww          , Ww          , Ss          , Ss^Vhs      , Ss          , Ww          , Ggf         , Ww          , Ww^Bw\      , Re          , Gs^Fms      , Hh^Fds      , Hh^Vc       , Hh          , Mm          , Mm          , Ww          , Mm          , Mm          , Mm          , Mm          , Mm          , Mm          , Mm          , Mm          
Wo          , Wo          , Ww          , Ww          , Ww          , Ww          , Ww          , Ggf         , Ss          , Ww          , Ww          , Ww          , Ss          , Ww          , Ss          , Gg          , Gg          , Re          , Hh^Fds      , Mm          , Mm          , Mm          , Mm          , Mm          , Mm          , Mm          , Mm          , Mm          , Mm          , Mm          , Mm          , Mm          
Wo          , Wo          , Ww          , Ww          , Ww          , Ww          , Ww          , Ss          , Ss          , Ss          , Ss          , Ss          , Gg          , Gg          , Gg          , Ggf         , Re          , Re          , Re          , Mm          , Mm          , Mm          , Mm          , Mm          , Mm          , Mm          , Mm          , Mm          , Hh^Fds      , Mm          , Mm          , Mm          
Wo          , Wo          , Wo          , Ww          , Ww          , Ww          , Ww          , Ss          , Ggf         , Gs^Fms      , Gs^Fms      , Gs^Fms      , Ggf         , Ggf         , Ce          , Ce          , Ce          , Ggf         , Re          , Hh          , Mm          , Mm          , Mm          , Mm          , Mm          , Mm          , Mm          , Mm          , Hh^Fp       , Hh^Fds      , Mm          , Mm          
Wo          , Wo          , Wo          , Ww          , Ww          , Ww          , Ww          , Ww          , Ss          , Gs^Fp       , Ss          , Ss          , Ggf         , Gg          , Ce          , 1 Ke        , Ce          , Re          , Re          , Hh^Fds      , Hh^Fds      , Mm          , Mm          , Hh^Fp       , Mm          , Mm          , Mm          , Mm          , Mm          , Hh^Fp       , Mm          , Mm          
Wo          , Wo          , Wo          , Ww          , Ww          , Ww          , Ww          , Ww          , Ww          , Ss          , Gs^Fms      , Gs^Fds      , Gg          , Gg          , Ggf         , Ce          , Gg          , Ggf         , Gg          , Re          , Re          , Hh          , Mm          , Mm          , Mm          , Mm          , Mm          , Mm          , Mm          , Mm          , Mm          , Mm          
Wo          , Wo          , Wo          , Wo          , Ww          , Ww          , Ww          , Ww          , Ww          , Ss          , Gs^Fms      , Gs^Fds      , Ss          , Gg          , Gs^Fds      , Gg          , Gs^Fds      , Gs^Fds      , Gs^Fds      , Ggf         , Re          , Mm          , Mm          , Mm          , Mm          , Hh          , Hh^Fp       , Mm          , Mm          , Mm          , Mm          , Mm          
Wo          , Wo          , Wo          , Wo          , Ww          , Ww          , Ww          , Ww          , Ww          , Ss          , Ss          , Ss^Vhs      , Gs^Fds      , Gs^Fms      , Gs^Fp       , Gs^Fds      , Gs^Fms      , Gs^Fms      , Gs^Fds      , Ggf         , Re          , Hh^Fds      , Mm          , Mm          , Mm          , Mm          , Hh^Fds      , Hh^Fp       , Mm          , Mm          , Mm          , Mm          
Wo          , Wo          , Wo          , Ww          , Ww          , Ww          , Ww          , Ww          , Ww          , Ww          , Ggf         , Ss          , Gs^Fms      , Ss          , Gs^Fms      , Gs^Fms      , Gs^Fms      , Gs^Fms      , Gs^Fds      , Gg^Vc       , Re          , Mm          , Mm          , Mm          , Mm          , Mm          , Mm          , Mm          , Mm          , Mm          , Mm          , Mm          
Wo          , Wo          , Wo          , Wo          , Ww          , Ww          , Ww          , Ww          , Ww          , Ww          , Ww          , Gs^Fms      , Ss          , Gs^Fms      , Gs^Fms      , Gs^Fds      , Gs^Fms      , Gs^Fds      , Gs^Fms      , Gs^Fds      , Gs^Fms      , Re          , Re          , Mm          , Mm          , Mm          , Mm          , Mm          , Mm          , Mm          , Mm          , Mm          
