border_size=1
usage=map

Mm          , Mm          , Mm          , Mm          , Mm          , Mm          , Mm          , Mm          , Mm          , Mm          , Mm          , Mm          , Hh          , Hh          , Hh^Fp       , Hh          , Hh          , Re          , Re          , Hh          , Hh          , Hh          , Hh          , Hh          , Hh^Fmf      , Hh          , Hh          , Hh          , Hh          , Hh          , Re^Gvs      , Re^Gvs      , Re^Gvs      , Re^Gvs      , Re          , Gs^Fmf      , Gs^Fdf      , Gs^Fmf      , Gs^Fdf      , Gs^Fdf      , Gs^Fdf      , Gs^Fdf      , Gs^Fdf      
Mm          , Mm          , Mm          , Mm          , Mm          , Mm          , Mm          , Mm          , Mm          , Mm          , Mm          , Mm          , Mm          , Hh          , Hh^Fp       , Hh          , Hh^Fmf      , Hh          , Hh          , Re          , Re          , Hh          , Hh          , Hh^Fp       , Hh^Fmf      , Hh^Fdf      , Hh          , Hh^Fp       , Ss          , Re^Gvs      , Ss          , Ss          , Ss          , Re^Gvs      , Re          , Gs^Fdf      , Gs^Fmf      , Gs^Fdf      , Gs^Fdf      , Gs^Fmf      , Gs^Fdf      , Gs^Fmf      , Gs^Fdf      
Mm          , Mm          , Mm          , Mm          , Mm          , Mm          , Mm          , Mm          , Mm          , Mm          , Mm          , Mm          , Hh          , Hh^Fp       , Hh          , Hh^Fdf      , Hh          , Hh          , Hh^Fp       , Hh          , Re          , Gg^Vh       , Hh          , Hh^Fp       , Hh          , Hh^Fmf      , Hh          , Hh          , Re^Gvs      , Re^Gvs      , Re^Gvs      , Ss          , Re^Gvs      , Re^Gvs      , Re          , Gs^Fdf      , Gs^Fdf      , Gs^Fdf      , Gs^Fdf      , Gs^Fdf      , Gs^Fdf      , Gs^Fdf      , Gs^Fdf      
Mm          , Mm          , Mm          , Mm          , Mm          , Mm          , Mm          , Mm          , Mm          , Mm          , Mm          , Mm^Vhh      , Hh          , Hh          , Hh          , Hh          , Hh          , Hh          , Hh          , Hh          , Hh          , Re          , Re          , Hh          , Hh          , Hh          , Hh^Fp       , Hh          , Hh          , Ss          , Ss          , Re^Gvs      , Ss          , Re^Gvs      , Ww          , Re          , Re          , Ggf         , Gs^Fmf      , Gs^Fdf      , Gs^Fmf      , Gs^Fdf      , Rr          
Mm          , Mm          , Mm          , Mm          , Mm          , Mm          , Mm          , Mm          , Mm          , Mm          , Mm          , Mm          , Hh^Fp       , Hh^Fmf      , Hh          , Hh          , Hh^Fp       , Hh^Fp       , Hh^Fmf      , Hh          , Hh^Fp       , Hh          , Hh          , Re          , Ww          , Hh^Fp       , Hh          , Hh^Fp       , Hh          , Ss          , Re^Gvs      , Ss          , Ww          , Re          , Re^Gvs      , Re^Gvs      , Gg^Wm       , Re          , Re          , Gg^Vh       , Rr          , Rr          , Gs^Fdf      
Mm          , Mm          , Mm          , Mm          , Ww          , Mm          , Mm          , Mm          , Mm          , Mm          , Hh          , Hh          , Hh          , Hh^Fp       , Hh          , Hh          , Hh          , Hh^Fp       , Hh          , Hh          , Hh^Fp       , Hh^Fp       , Hh          , Ww          , Ww          , Hh          , Hh^Fp       , Hh          , Re          , Re          , Re          , Ww          , Re^Gvs      , Ss          , Ss          , Re^Gvs      , Re^Gvs      , Gs^Fmf      , Rr          , Rr          , Gs^Fdf      , Gs^Fdf      , Gs^Fdf      
Mm          , Mm          , Mm          , Ww          , Ww          , Ww          , Mm          , Hh          , Hh          , Mm          , Hh          , Hh^Fp       , Hh^Fp       , Hh          , Hh          , Hh          , Ww          , Hh          , Hh          , Hh          , Re          , Hh^Fp       , Re          , Re          , Re          , Hh^Fp       , Gg^Vh       , Re          , Hh^Fmf      , Hh^Fdf      , Re^Gvs      , Re^Gvs      , Re^Gvs      , Ss          , Re^Gvs      , Ss          , Ss          , Gs^Fdf      , Rr          , Gs^Fdf      , Gs^Fdf      , Gs^Fmf      , Gs^Fdf      
Mm          , Mm          , Mm          , Mm          , Mm          , Mm          , Mm          , Mm          , Mm          , Hh          , Hh^Fp       , Hh^Fp       , Hh^Vc       , Hh          , Re          , Ww          , Ww          , Re          , Re          , Re          , Gg^Vh       , Re          , Hh          , Hh^Fp       , Hh          , Re          , Re          , Re          , Re^Gvs      , Ss          , Ss          , Re^Gvs      , Ss          , Re^Gvs      , Re^Gvs      , Re^Gvs      , Re          , Gs^Fdf      , Rr          , Gs^Fmf      , Gs^Fmf      , Gs^Fdf      , Re^Gvs      
Hh          , Mm          , Mm          , Mm          , Mm          , Mm^Vhh      , Mm          , Mm          , Hh          , Hh          , Hh          , Hh          , Re          , Re          , Hh^Fp       , Hh          , Hh          , Hh          , Re          , Hh          , Hh          , Hh^Fdf      , Hh^Fmf      , Hh^Fp       , Hh          , Hh^Fmf      , Gg^Wm       , Re          , Ww          , Ss          , Ss          , Re^Gvs      , Re^Gvs      , Ss          , Gs^Fdf      , Gs^Fmf      , Rr          , Rr          , Gs^Fdf      , Re          , Ww          , Re^Gvs      , Re^Gvs      
Hh          , Mm          , Mm          , Mm          , Ww          , Mm          , Mm          , Mm          , Hh          , Hh          , Re          , Ww          , Ce          , Hh          , Hh          , Hh^Fp       , Hh          , Hh          , Hh          , Re          , Re          , Hh          , Hh          , Hh          , Re^Gvs      , Re^Gvs      , Ss          , Re^Gvs      , Ss          , Ww          , Ww          , Re^Gvs      , Re          , Gs^Fdf      , Rr          , Rr          , Gs^Fmf      , Gs^Fmf      , Re^Gvs      , Re^Gvs      , Re^Gvs      , Ww          , Re          
Re          , Hh          , Hh^Fp       , Mm          , Hh          , Mm          , Hh          , Hh          , Hh          , Hh          , Re          , Ce          , Ce          , 1 Ke        , Hh          , Hh          , Ww          , Ww          , Ww          , Hh          , Hh          , Re          , Re          , Re^Gvs      , Ww          , Re^Gvs      , Ss          , Ss          , Re^Gvs      , Re^Gvs      , Re^Gvs      , Re          , Gg^Vh       , Re          , Rr          , Gs^Fdf      , Re^Gvs      , Re^Gvs      , Ss          , Re^Gvs      , Ss          , Re^Gvs      , Re          
Hh          , Re          , Hh^Fp       , Hh          , Hh          , Hh^Fp       , Hh^Fp       , Hh          , Re          , Ww          , Hh          , Ce          , Ce          , Ce          , Hh          , Hh          , Hh          , Ww          , Ww          , Hh          , Hh          , Hh^Fdf      , Re^Gvs      , Ww          , Re^Gvs      , Re          , Re          , Re^Gvs      , Ss          , Ss          , Re          , Ww          , Re^Gvs      , Gs^Fmf      , Rr          , Gs^Fdf      , Re^Gvs      , Ss          , Ss          , Re^Gvs      , Re          , Re          , Re^Gvs      
Hh          , Re          , Ww          , Hh          , Hh          , Hh^Fp       , Hh^Fp       , Hh          , Re          , Hh^Vc       , Hh^Fp       , Hh^Fp       , Hh          , Hh          , Hh          , Hh^Fp       , Hh          , Hh          , Hh          , Hh          , Hh^Fp       , Hh          , Hh          , Ss          , Ss          , Re^Gvs      , Re^Gvs      , Ww          , Ww          , Re          , Re^Gvs      , Re^Gvs      , Re^Gvs      , Gs^Fdf      , Rr          , Re          , Re^Gvs      , Ss          , Ww          , Ww          , Re^Gvs      , Re^Gvs      , Re^Gvs      
Mm          , Hh^Fp       , Hh          , Ww          , Re          , Hh          , Hh          , Hh          , Re          , Hh          , Hh          , Hh^Fp       , Ww          , Ww          , Hh          , Hh^Fp       , Re          , Hh          , Hh          , Hh^Fp       , Hh^Fp       , Hh          , Hh          , Re^Gvs      , Ss          , Ss          , Re          , Ww          , Re^Gvs      , Ww          , Re^Gvs      , Ss          , Ss          , Re          , Rr          , Gs^Fmf      , Re          , Ww          , Re^Gvs      , Re^Gvs      , Ss          , Re^Gvs      , Re^Gvs      
Mm          , Mm          , Hh^Fp       , Hh^Fp       , Hh          , Re          , Re          , Hh          , Ww          , Ww          , Hh          , Hh          , Hh          , Ww          , Hh          , Hh          , Re          , Hh^Vc       , Re          , Hh^Fp       , Hh          , Hh          , Ggf         , Re^Gvs      , Ww          , Ww          , Ss          , Ss          , Re^Gvs      , Re          , Re^Gvs      , Ss          , Re^Gvs      , Gs^Fmf      , Rr          , Re          , Re^Gvs      , Re^Gvs      , Ss          , Ss          , Ss          , Ss          , Re^Gvs      
Mm          , Mm          , Mm          , Hh^Fp       , Hh^Fp       , Hh          , Gg^Vh       , Re          , Hh          , Ww          , Re          , Hh          , Hh          , Hh          , Hh          , Hh^Fp       , Hh^Fp       , Re          , Hh^Fp       , Re          , Gg          , Ggf         , Re          , Ww          , Gg^Vh       , Re^Gvs      , Re^Gvs      , Ss          , Re^Gvs      , Ss          , Ss          , Re^Gvs      , Gs^Fdf      , Gs^Fmf      , Rr          , Gs^Fmf      , Re^Gvs      , Re^Gvs      , Ss          , Ss          , Ss          , Re^Gvs      , Re          
Mm          , Mm          , Mm          , Hh^Fp       , Mm          , Hh          , Hh          , Hh          , Hh          , Hh          , Re          , Hh          , Hh          , Hh          , Hh          , Hh^Fp       , Hh          , Hh          , Hh          , Gg          , Gs^Fdf      , Gs^Fdf      , Re          , Ggf         , Gs^Fmf      , Gs^Fdf      , Ggf         , Re^Gvs      , Gg          , Ss          , Re^Gvs      , Re^Gvs      , Gs^Fdf      , Gg^Wm       , Ww          , Re          , Gs^Fdf      , Re^Gvs      , Re^Gvs      , Ss          , Ww          , Ww          , Re^Gvs      
Mm          , Mm          , Mm          , Mm          , Mm          , Mm          , Hh          , Hh^Fp       , Hh^Fp       , Hh          , Ww          , Ww          , Re          , Hh          , Hh          , Hh          , Hh^Fp       , Hh          , Ww          , Ggf         , Gs^Fdf      , Gs^Fmf      , Re          , Re          , Re          , Gs^Fdf      , Ww          , Ww          , Ww          , Ggf         , Ww          , Gs^Fdf      , Gs^Fmf      , Ggf         , Ggf         , Rr          , Rr          , Gs^Fdf      , Gs^Fdf      , Re          , Re^Gvs      , Re^Gvs      , Re^Gvs      
Mm          , Mm          , Mm          , Mm          , Mm          , Mm          , Hh          , Hh^Fp       , Hh          , Hh          , Hh          , Ww          , Hh          , Re          , Hh          , Hh^Fp       , Hh^Fp       , Hh          , Ggf         , Ggf         , Re          , Re          , Gg          , Gs^Fmf      , Gs^Fdf      , Ds          , Ww          , Ww          , Ww          , Ww          , Ww          , Ww          , Gs^Fdf      , Gs^Fdf      , Gs^Fdf      , Gs^Fmf      , Gs^Fdf      , Rr          , Rr          , Re          , Re^Gvs      , Ss          , Ss          
Mm          , Mm          , Mm          , Mm          , Mm          , Mm          , Hh          , Hh          , Hh^Fp       , Hh          , Hh          , Hh          , Hh          , Re          , Ww          , Re          , Re          , Hh          , Ww          , Re          , Gg          , Ww          , Ggf         , Gs^Fdf      , Gs^Fdf      , Ds          , Ds          , Ww          , Ww          , Ww          , Ww          , Ww          , Ch          , Ch          , Ch          , Gs^Fmf      , Gs^Fdf      , Gg^Vh       , Rr          , Gs^Fdf      , Re^Gvs      , Re^Gvs      , Ss          
Mm          , Mm          , Mm          , Mm          , Mm          , Hh          , Hh          , Hh          , Hh^Fp       , Hh^Fp       , Hh^Fp       , Hh          , Hh          , Hh          , Hh^Fmf      , Gg^Vh       , Hh          , Ww          , Hh          , Rr          , Rr          , Ww          , Rr          , Gg          , Re          , Re          , Gs^Fmf      , Gs^Fdf      , Gs^Fdf      , Ww          , Ch          , Ch          , Ggf         , Ggf         , Ggf         , Ch          , Rr          , Rr          , Gs^Fdf      , Gs^Fdf      , Gg          , Re^Gvs      , Re^Gvs      
Mm          , Mm          , Mm          , Mm          , Mm          , Mm          , Hh          , Hh          , Hh          , Hh^Fp       , Hh          , Hh          , Hh          , Hh          , Hh          , Hh^Fp       , Hh^Fdf      , Re          , Hh^Fmf      , Hh^Fdf      , Hh^Fmf      , Gg          , Ww          , Ww          , Rr          , Gg          , Rr          , Rr          , Rr          , Ch          , Ggf         , Ggf         , Rr          , Ww          , Ww          , Rr          , Ggf         , Ch          , Ch          , Gg          , Gs^Fmf      , Gg          , Gg          
Mm          , Mm          , Ww          , Mm          , Mm          , Mm          , Hh          , Hh          , Hh          , Hh          , Hh          , Hh          , Re^Gvs      , Hh          , Hh          , Hh^Fdf      , Hh          , Re          , Gs^Fmf      , Hh^Fdf      , Re^Gvs      , Ss          , Re^Gvs      , Ww          , Gg          , Rr          , Gs^Fdf      , Ch          , Ggf         , Rr          , Ww          , Ww          , Rr          , Ggf         , Ggf         , Rp^Vhc      , Ww          , Ggf         , Ch          , Gs^Fdf      , Gs^Fdf      , Ggf         , Re^Gvs      
Mm          , Mm          , Mm          , Mm          , Mm          , Mm          , Hh^Fp       , Hh^Fp       , Hh^Fp       , Hh          , Re^Gvs      , Re^Gvs      , Ss          , Re^Gvs      , Re^Gvs      , Hh          , Ww          , Re          , Re^Gvs      , Re^Gvs      , Re^Gvs      , Re^Gvs      , Re^Gvs      , Re^Gvs      , Re^Gvs      , Re          , Gs^Fdf      , Ch          , Ggf         , Rp^Vhc      , Rr          , Ww          , Ch          , Ch          , Ch          , Ww          , Rp^Vhc      , Ggf         , Ch          , Gs^Fmf      , Re^Gvs      , Re^Gvs      , Re^Gvs      
Mm          , Mm          , Mm          , Mm          , Hh          , Hh          , Hh^Fp       , Hh^Fp       , Hh          , Gg^Vh       , Re          , Re^Gvs      , Ss          , Ss          , Re^Gvs      , Re^Gvs      , Ww          , Ww          , Ww          , Re^Gvs      , Ss          , Ss          , Re^Gvs      , Re^Gvs      , Ww          , Re          , Gs^Fmf      , Ch          , Ggf         , Ggf         , Ww          , Ggf         , Ch          , 2 Kh        , Ch          , Ggf         , Rr          , Ggf         , Ch          , Gs^Fmf      , Re^Gvs      , Re^Gvs      , Re^Gvs      
Mm          , Mm          , Mm          , Mm          , Hh          , Hh          , Hh          , Hh          , Hh          , Re^Gvs      , Ss          , Re          , Re          , Ss          , Re          , Re          , Re^Gvs      , Re^Gvs      , Re^Gvs      , Re          , Re          , Ss          , Re          , Ww          , Re^Gvs      , Re^Gvs      , Gs^Fdf      , Ch          , Ggf         , Rp^Vhc      , Rr          , Ggf         , Ggf         , Ch          , Ggf         , Rr          , Ww          , Ggf         , Ch          , Gg          , Re^Gvs      , Re^Gvs      , Re^Gvs      
Mm          , Mm          , Hh          , Hh          , Hh          , Hh          , Hh          , Hh          , Re^Gvs      , Re^Gvs      , Ss          , Ss          , Re          , Re          , Gg^Wm       , Re          , Re^Gvs      , Re^Gvs      , Ss          , Re^Gvs      , Re^Gvs      , Ww          , Re^Gvs      , Re^Gvs      , Re^Gvs      , Re^Gvs      , Gg          , Ch          , Rr          , Rr          , Ggf         , Ww          , Ww          , Ggf         , Rr          , Ww          , Ww          , Ggf         , Ch          , Gg          , Gg          , Re^Gvs      , Re^Gvs      
Hh          , Hh          , Ww          , Hh          , Hh          , Hh          , Gg^Wm       , Re^Gvs      , Re^Gvs      , Ss          , Re^Gvs      , Ss          , Re          , Ggf         , Ww          , Re          , Re^Gvs      , Ss          , Ss          , Ss          , Re^Gvs      , Ww          , Re          , Gg^Wm       , Gg          , Ww          , Ww          , Rr          , Gg          , Ch          , Ch          , Ww          , Ww          , Rr          , Ggf         , Rp^Vhc      , Ggf         , Rr          , Rr          , Ggf         , Ww          , Ww          , Ggf         
Hh          , Ww          , Ww          , Hh          , Hh          , Gg^Vh       , Ww          , Re^Gvs      , Gs^Fdf      , Gs^Fdf      , Gs^Fdf      , Re^Gvs      , Gs^Fmf      , Ggf         , Ww          , Ww          , Re^Gvs      , Re^Gvs      , Ss          , Ss          , Re^Gvs      , Re^Gvs      , Gg^Vh       , Re          , Rr          , Ww          , Re          , Gg          , Re          , Gg          , Gg          , Ch          , Ch          , Ggf         , Ww          , Ggf         , Ch          , Ch          , Gg          , Rr          , Ww          , Ww          , Gg          
Hh          , Hh          , Hh          , Hh          , Re^Gvs      , Re^Gvs      , Re^Gvs      , Re          , Re          , Gs^Fmf      , Gs^Fmf      , Gs^Fdf      , Re          , Re          , Re^Gvs      , Re          , Ww          , Re^Gvs      , Re^Gvs      , Re^Gvs      , Gg          , Gg          , Rr          , Ww          , Ww          , Gg          , Re          , Ww          , Ww          , Ggf         , Ww          , Gg          , Gg          , Ch          , Ch          , Ch          , Gg          , Gg          , Ggf         , Ww          , Ww          , Rr          , Rr          
Hh          , Hh          , Hh          , Hh          , Ss          , Ss          , Ss          , Re^Gvs      , Re^Gvs      , Re          , Re          , Re          , Re^Gvs      , Re^Gvs      , Ss          , Re^Gvs      , Re^Gvs      , Re          , Re          , Gs^Fmf      , Rr          , Rr          , Gg          , Ww          , Ggf         , Gg          , Gg          , Re          , Gg          , Ggf         , Ww          , Ww          , Gg          , Gg          , Ggf         , Gg          , Ww          , Ww          , Ggf         , Gg          , Ggf         , Gg          , Gg          
Hh          , Hh          , Re^Gvs      , Re^Gvs      , Ss          , Ss          , Re^Gvs      , Re^Gvs      , Ww          , Ww          , Re^Gvs      , Re^Gvs      , Re^Gvs      , Ss          , Re^Gvs      , Re^Gvs      , Gs^Fmf      , Gs^Fdf      , Rr          , Rr          , Gg          , Gg          , Gg          , Ggf         , Ggf         , Ww          , Gg          , Gg          , Ggf         , Gg          , Gg          , Gg          , Gg          , Ggf         , Gg          , Gg          , Gg          , Gg          , Gg          , Gg          , Gg          , Gg          , Gg          
