border_size=1
usage=map

Mm          , Mm          , Mm          , Mm          , Mm          , Mm          , Mm          , Mm          , Mm          , Mm          , Mm          , Mm          , Hh          , Hh          , Hh^Fp       , Hh          , Hh          , Re          , Re          , Hh          , Hh          , Hh          , Hh          , Hh          , Hh^Fmf      , Hh          , Hh          , Hh          , Hh          , Hh          , Re^Gvs      , Re^Gvs      , Re^Gvs      , Re^Gvs      , Re          , Gs^Fmf      , Gs^Fdf      , Gs^Fmf      , Gs^Fdf      , Gs^Fdf      , Gs^Fdf      , Gs^Fdf      , Gs^Fdf      
Mm          , Mm          , Mm          , Mm          , Mm          , Mm          , Mm          , Mm          , Mm          , Mm          , Mm          , Mm          , Mm          , Hh          , Hh^Fp       , Hh          , Hh^Fmf      , Hh          , Hh          , Re          , Re          , Hh          , Hh          , Hh^Fp       , Hh^Fmf      , Hh^Fdf      , Hh          , Hh^Fp       , Re^Gvs      , Re^Gvs      , Re^Gvs      , Re^Gvs      , Re^Gvs      , Re^Gvs      , Re          , Gs^Fdf      , Gs^Fmf      , Gs^Fdf      , Gs^Fdf      , Gs^Fmf      , Gs^Fdf      , Gs^Fmf      , Gs^Fdf      
Mm          , Mm          , Mm          , Mm          , Mm          , Mm          , Mm          , Mm          , Mm          , Mm          , Mm          , Mm          , Hh          , Hh^Fp       , Hh          , Hh^Fdf      , Hh          , Hh          , Hh^Fp       , Hh          , Re          , Gg^Vh       , Hh          , Hh^Fp       , Hh          , Hh^Fmf      , Hh          , Hh          , Re^Gvs      , Re^Gvs      , Re^Gvs      , Re^Gvs      , Re^Gvs      , Re^Gvs      , Re          , Gs^Fdf      , Gs^Fdf      , Gs^Fdf      , Gs^Fdf      , Gs^Fdf      , Gs^Fdf      , Gs^Fdf      , Gs^Fdf      
Mm          , Mm          , Mm          , Mm          , Mm          , Mm          , Mm          , Mm          , Mm          , Mm          , Mm          , Mm^Vhh      , Hh          , Hh          , Hh          , Hh          , Hh          , Hh          , Hh          , Hh          , Hh          , Re          , Re          , Hh          , Hh          , Hh          , Hh^Fp       , Hh          , Hh          , Re^Gvs      , Re^Gvs      , Re^Gvs      , Re^Gvs      , Re^Gvs      , Re          , Re          , Re          , Ggf         , Gs^Fmf      , Gs^Fdf      , Gs^Fmf      , Gs^Fdf      , Rr          
Mm          , Mm          , Mm          , Mm          , Mm          , Mm          , Mm          , Mm          , Mm          , Mm          , Mm          , Mm          , Hh^Fp       , Hh^Fmf      , Hh          , Hh          , Hh^Fp       , Hh^Fp       , Hh^Fmf      , Hh          , Hh^Fp       , Hh          , Hh          , Re          , Re          , Hh^Fp       , Hh          , Hh^Fp       , Hh          , Re^Gvs      , Re^Gvs      , Re^Gvs      , Re          , Re          , Re^Gvs      , Re^Gvs      , Gg^Wm       , Re          , Re          , Gg^Vh       , Rr          , Rr          , Gs^Fdf      
Mm          , Mm          , Mm          , Mm          , Hh          , Mm          , Mm          , Mm          , Mm          , Mm          , Hh          , Hh          , Hh          , Hh^Fp       , Hh          , Hh          , Hh          , Hh^Fp       , Hh          , Hh          , Hh^Fp       , Hh^Fp       , Hh          , Gg          , Re          , Hh          , Hh^Fp       , Hh          , Re          , Re          , Re          , Re          , Re^Gvs      , Re^Gvs      , Re^Gvs      , Re^Gvs      , Re^Gvs      , Gs^Fmf      , Rr          , Rr          , Gs^Fdf      , Gs^Fdf      , Gs^Fdf      
Mm          , Mm          , Mm          , Hh          , Hh          , Hh          , Mm          , Hh          , Hh          , Mm          , Hh          , Hh^Fp       , Hh^Fp       , Hh          , Hh          , Hh          , Re          , Hh          , Hh          , Hh          , Re          , Hh^Fp       , Re          , Re          , Re          , Hh^Fp       , Gg^Vh       , Re          , Hh^Fmf      , Hh^Fdf      , Re^Gvs      , Re^Gvs      , Re^Gvs      , Re^Gvs      , Re^Gvs      , Re^Gvs      , Re^Gvs      , Gs^Fdf      , Rr          , Gs^Fdf      , Gs^Fdf      , Gs^Fmf      , Gs^Fdf      
Mm          , Mm          , Mm          , Mm          , Mm          , Mm          , Mm          , Mm          , Mm          , Hh          , Hh^Fp       , Hh^Fp       , Hh^Vc       , Hh          , Re          , Re          , Gg          , Re          , Re          , Re          , Gg^Vh       , Re          , Hh          , Hh^Fp       , Hh          , Re          , Re          , Re          , Re^Gvs      , Re^Gvs      , Re^Gvs      , Re^Gvs      , Re^Gvs      , Re^Gvs      , Re^Gvs      , Re^Gvs      , Re          , Gs^Fdf      , Rr          , Gs^Fmf      , Gs^Fmf      , Gs^Fdf      , Re^Gvs      
Hh          , Mm          , Mm          , Mm          , Mm          , Mm^Vhh      , Mm          , Mm          , Hh          , Hh          , Hh          , Hh          , Re          , Re          , Hh^Fp       , Hh          , Hh          , Hh          , Re          , Hh          , Hh          , Hh^Fdf      , Hh^Fmf      , Hh^Fp       , Hh          , Hh^Fmf      , Gg^Wm       , Re          , Re          , Re^Gvs      , Re^Gvs      , Re^Gvs      , Re^Gvs      , Re^Gvs      , Gs^Fdf      , Gs^Fmf      , Rr          , Rr          , Gs^Fdf      , Re          , Re          , Re^Gvs      , Re^Gvs      
Hh          , Mm          , Mm          , Mm          , Hh          , Mm          , Mm          , Mm          , Hh          , Hh          , Re          , Re          , Ce          , Hh          , Hh          , Hh^Fp       , Hh          , Hh          , Hh          , Re          , Re          , Hh          , Hh          , Hh          , Re^Gvs      , Re^Gvs      , Re^Gvs      , Re^Gvs      , Re^Gvs      , Re          , Re          , Re^Gvs      , Re          , Gs^Fdf      , Rr          , Rr          , Gs^Fmf      , Gs^Fmf      , Re^Gvs      , Re^Gvs      , Re^Gvs      , Re          , Re          
Re          , Hh          , Hh^Fp       , Mm          , Hh          , Mm          , Hh          , Hh          , Hh          , Hh          , Re          , Ce          , Ce          , 1 Ke        , Hh          , Hh          , Ggf         , Ggf         , Gg          , Hh          , Hh          , Re          , Re          , Re^Gvs      , Re          , Re^Gvs      , Re^Gvs      , Re^Gvs      , Re^Gvs      , Re^Gvs      , Re^Gvs      , Re          , Gg^Vh       , Re          , Rr          , Gs^Fdf      , Re^Gvs      , Re^Gvs      , Re^Gvs      , Re^Gvs      , Re^Gvs      , Re^Gvs      , Re          
Hh          , Re          , Hh          , Hh          , Hh          , Hh^Fp       , Hh^Fp       , Hh          , Re          , Re          , Hh          , Ce          , Ce          , Ce          , Hh          , Hh          , Hh          , Gg          , Ggf         , Hh          , Hh          , Hh^Fdf      , Re^Gvs      , Re          , Re^Gvs      , Re          , Re          , Re^Gvs      , Re^Gvs      , Re^Gvs      , Re          , Re          , Re^Gvs      , Gs^Fmf      , Rr          , Gs^Fdf      , Re^Gvs      , Re^Gvs      , Re^Gvs      , Re^Gvs      , Re          , Re          , Re^Gvs      
Hh          , Re          , Re          , Hh          , Hh          , Hh^Fp       , Hh^Fp       , Hh          , Re          , Hh^Vc       , Hh^Fp       , Hh^Fp       , Hh          , Hh          , Hh          , Hh^Fp       , Hh          , Hh          , Hh          , Hh          , Hh^Fp       , Hh          , Hh          , Re^Gvs      , Re^Gvs      , Re^Gvs      , Re^Gvs      , Re          , Re          , Re          , Re^Gvs      , Re^Gvs      , Re^Gvs      , Gs^Fdf      , Rr          , Re          , Re^Gvs      , Re^Gvs      , Re          , Re          , Re^Gvs      , Re^Gvs      , Re^Gvs      
Mm          , Hh          , Hh          , Re          , Re          , Hh          , Hh          , Hh          , Re          , Hh          , Hh          , Hh^Fp       , Ggf         , Gg          , Hh          , Hh^Fp       , Re          , Hh          , Hh          , Hh^Fp       , Hh^Fp       , Hh          , Hh          , Re^Gvs      , Re^Gvs      , Re^Gvs      , Re          , Re          , Re^Gvs      , Re          , Re^Gvs      , Re^Gvs      , Re^Gvs      , Re          , Rr          , Gs^Fmf      , Re          , Re          , Re^Gvs      , Re^Gvs      , Re^Gvs      , Re^Gvs      , Re^Gvs      
Mm          , Mm          , Hh^Fp       , Hh          , Hh          , Re          , Re          , Hh          , Re          , Gg          , Hh          , Hh          , Hh          , Gg          , Hh          , Hh          , Re          , Hh^Vc       , Re          , Hh^Fp       , Hh          , Hh          , Ggf         , Re^Gvs      , Re          , Re          , Re^Gvs      , Re^Gvs      , Re^Gvs      , Re          , Re^Gvs      , Re^Gvs      , Re^Gvs      , Gs^Fmf      , Rr          , Re          , Re^Gvs      , Re^Gvs      , Re^Gvs      , Re^Gvs      , Re^Gvs      , Re^Gvs      , Re^Gvs      
Mm          , Mm          , Mm          , Hh^Fp       , Hh^Fp       , Hh          , Gg^Vh       , Re          , Hh          , Re          , Re          , Hh          , Hh          , Hh          , Hh          , Hh^Fp       , Hh^Fp       , Re          , Hh^Fp       , Re          , Gg          , Ggf         , Re          , Re          , Gg^Vh       , Re^Gvs      , Re^Gvs      , Re^Gvs      , Re^Gvs      , Re^Gvs      , Re^Gvs      , Re^Gvs      , Gs^Fdf      , Gs^Fmf      , Rr          , Gs^Fmf      , Re^Gvs      , Re^Gvs      , Re^Gvs      , Re^Gvs      , Re^Gvs      , Re^Gvs      , Re          
Mm          , Mm          , Mm          , Hh^Fp       , Mm          , Hh          , Hh          , Hh          , Hh          , Hh          , Re          , Hh          , Hh          , Hh          , Hh          , Hh^Fp       , Hh          , Hh          , Hh          , Gg          , Gs^Fdf      , Gs^Fdf      , Re          , Ggf         , Gs^Fmf      , Gs^Fdf      , Ggf         , Re^Gvs      , Gg          , Re^Gvs      , Re^Gvs      , Re^Gvs      , Gs^Fdf      , Gg^Wm       , Rr          , Re          , Gs^Fdf      , Re^Gvs      , Re^Gvs      , Re^Gvs      , Re          , Re          , Re^Gvs      
Mm          , Mm          , Mm          , Mm          , Mm          , Mm          , Hh          , Hh^Fp       , Hh^Fp       , Hh          , Gg          , Re          , Re          , Hh          , Hh          , Hh          , Hh^Fp       , Hh          , Gg          , Ggf         , Gs^Fdf      , Gs^Fmf      , Re          , Re          , Re          , Gs^Fdf      , Ww          , Ww          , Ww          , Ggf         , Ww          , Gs^Fdf      , Gs^Fmf      , Ggf         , Ggf         , Rr          , Rr          , Gs^Fdf      , Gs^Fdf      , Re          , Re^Gvs      , Re^Gvs      , Re^Gvs      
Mm          , Mm          , Mm          , Mm          , Mm          , Mm          , Hh          , Hh^Fp       , Hh          , Hh          , Hh          , Ggf         , Hh          , Re          , Hh          , Hh^Fp       , Hh^Fp       , Hh          , Ggf         , Ggf         , Re          , Re          , Gg          , Gs^Fmf      , Gs^Fdf      , Ds          , Ww          , Ww          , Ww          , Ww          , Ww          , Ww          , Gs^Fdf      , Gs^Fdf      , Gs^Fdf      , Gs^Fmf      , Gs^Fdf      , Rr          , Rr          , Re          , Re^Gvs      , Re^Gvs      , Re^Gvs      
Mm          , Mm          , Mm          , Mm          , Mm          , Mm          , Hh          , Hh          , Hh^Fp       , Hh          , Hh          , Hh          , Hh          , Re          , Re          , Re          , Re          , Hh          , Re          , Re          , Gg          , Ggf         , Ggf         , Gs^Fdf      , Gs^Fdf      , Ds          , Ds          , Ww          , Ww          , Ww          , Ww          , Ww          , Ch          , Ch          , Ch          , Gs^Fmf      , Gs^Fdf      , Gg^Vh       , Rr          , Gs^Fdf      , Re^Gvs      , Re^Gvs      , Re^Gvs      
Mm          , Mm          , Mm          , Mm          , Mm          , Hh          , Hh          , Hh          , Hh^Fp       , Hh^Fp       , Hh^Fp       , Hh          , Hh          , Hh          , Hh^Fmf      , Gg^Vh       , Hh          , Re          , Hh          , Rr          , Rr          , Rr          , Rr          , Gg          , Re          , Re          , Gs^Fmf      , Gs^Fdf      , Gs^Fdf      , Ww          , Ch          , Ch          , Ggf         , Ggf         , Ggf         , Ch          , Rr          , Rr          , Gs^Fdf      , Gs^Fdf      , Gg          , Re^Gvs      , Re^Gvs      
Mm          , Mm          , Mm          , Mm          , Mm          , Mm          , Hh          , Hh          , Hh          , Hh^Fp       , Hh          , Hh          , Hh          , Hh          , Hh          , Hh^Fp       , Hh^Fdf      , Re          , Hh^Fmf      , Hh^Fdf      , Hh^Fmf      , Gg          , Ggf         , Rr          , Rr          , Gg          , Rr          , Rr          , Rr          , Ch          , Ggf         , Ggf         , Rr          , Rr          , Rr          , Rr          , Ggf         , Ch          , Ch          , Gg          , Gs^Fmf      , Gg          , Gg          
Mm          , Mm          , Hh          , Mm          , Mm          , Mm          , Hh          , Hh          , Hh          , Hh          , Hh          , Hh          , Re^Gvs      , Hh          , Hh          , Hh^Fdf      , Hh          , Re          , Gs^Fmf      , Hh^Fdf      , Re^Gvs      , Re^Gvs      , Re^Gvs      , Ggf         , Gg          , Rr          , Gg          , Ch          , Ggf         , Rr          , Rr          , Rr          , Rr          , Ggf         , Ggf         , Rp^Vhc      , Ggf         , Ggf         , Ch          , Gs^Fdf      , Gs^Fdf      , Ggf         , Re^Gvs      
Mm          , Mm          , Mm          , Mm          , Mm          , Mm          , Hh^Fp       , Hh^Fp       , Hh^Fp       , Hh          , Re^Gvs      , Re^Gvs      , Re^Gvs      , Re^Gvs      , Re^Gvs      , Hh          , Gg          , Re          , Re^Gvs      , Re^Gvs      , Re^Gvs      , Re^Gvs      , Re^Gvs      , Re^Gvs      , Re^Gvs      , Re          , Gs^Fdf      , Ch          , Ggf         , Rp^Vhc      , Rr          , Ggf         , Ch          , Ch          , Ch          , Ggf         , Rp^Vhc      , Ggf         , Ch          , Gs^Fmf      , Re^Gvs      , Re^Gvs      , Re^Gvs      
Mm          , Mm          , Mm          , Mm          , Hh          , Hh          , Hh^Fp       , Hh^Fp       , Hh          , Gg^Vh       , Re          , Re^Gvs      , Re^Gvs      , Re^Gvs      , Re^Gvs      , Re^Gvs      , Re          , Re          , Re          , Re^Gvs      , Re^Gvs      , Re^Gvs      , Re^Gvs      , Re^Gvs      , Re          , Re          , Gs^Fmf      , Ch          , Ggf         , Ggf         , Rr          , Ggf         , Ch          , 2 Kh        , Ch          , Ggf         , Rr          , Ggf         , Ch          , Gs^Fmf      , Re^Gvs      , Re^Gvs      , Re^Gvs      
Mm          , Mm          , Mm          , Mm          , Hh          , Hh          , Hh          , Hh          , Hh          , Re^Gvs      , Re^Gvs      , Re          , Re          , Re^Gvs      , Re          , Re          , Re^Gvs      , Re^Gvs      , Re^Gvs      , Re          , Re          , Re^Gvs      , Re          , Re          , Re^Gvs      , Re^Gvs      , Gs^Fdf      , Ch          , Ggf         , Rp^Vhc      , Rr          , Ggf         , Ggf         , Ch          , Ggf         , Rr          , Ggf         , Ggf         , Ch          , Gg          , Re^Gvs      , Re^Gvs      , Re^Gvs      
Mm          , Mm          , Hh          , Hh          , Hh          , Hh          , Hh          , Hh          , Re^Gvs      , Re^Gvs      , Re^Gvs      , Re^Gvs      , Re          , Re          , Gg^Wm       , Re          , Re^Gvs      , Re^Gvs      , Re^Gvs      , Re^Gvs      , Re^Gvs      , Re          , Re^Gvs      , Re^Gvs      , Re^Gvs      , Re^Gvs      , Gg          , Ch          , Rr          , Rr          , Ggf         , Rr          , Rr          , Ggf         , Rr          , Rr          , Rr          , Ggf         , Ch          , Gg          , Gg          , Re^Gvs      , Re^Gvs      
Hh          , Hh          , Gg          , Hh          , Hh          , Hh          , Gg^Wm       , Re^Gvs      , Re^Gvs      , Re^Gvs      , Re^Gvs      , Re^Gvs      , Re          , Ggf         , Ggf         , Re          , Re^Gvs      , Re^Gvs      , Re^Gvs      , Re^Gvs      , Re^Gvs      , Re          , Re          , Gg^Wm       , Gg          , Gg          , Rr          , Rr          , Gg          , Ch          , Ch          , Ggf         , Ggf         , Rr          , Ggf         , Rp^Vhc      , Ggf         , Rr          , Rr          , Ggf         , Gg          , Ggf         , Ggf         
Hh          , Gg          , Gg          , Hh          , Hh          , Gg^Vh       , Re          , Re^Gvs      , Gs^Fdf      , Gs^Fdf      , Gs^Fdf      , Re^Gvs      , Gs^Fmf      , Ggf         , Re          , Re          , Re^Gvs      , Re^Gvs      , Re^Gvs      , Re^Gvs      , Re^Gvs      , Re^Gvs      , Gg^Vh       , Re          , Rr          , Rr          , Re          , Gg          , Re          , Gg          , Gg          , Ch          , Ch          , Ggf         , Ggf         , Ggf         , Ch          , Ch          , Gg          , Rr          , Rr          , Ggf         , Gg          
Hh          , Hh          , Hh          , Hh          , Re^Gvs      , Re^Gvs      , Re^Gvs      , Re          , Re          , Gs^Fmf      , Gs^Fmf      , Gs^Fdf      , Re          , Re          , Re^Gvs      , Re          , Re          , Re^Gvs      , Re^Gvs      , Re^Gvs      , Gg          , Gg          , Rr          , Rr          , Gg          , Gg          , Re          , Re          , Re          , Ggf         , Ggf         , Gg          , Gg          , Ch          , Ch          , Ch          , Gg          , Gg          , Ggf         , Ggf         , Gg          , Rr          , Rr          
Hh          , Hh          , Hh          , Hh          , Re^Gvs      , Re^Gvs      , Re^Gvs      , Re^Gvs      , Re^Gvs      , Re          , Re          , Re          , Re^Gvs      , Re^Gvs      , Re^Gvs      , Re^Gvs      , Re^Gvs      , Re          , Re          , Gs^Fmf      , Rr          , Rr          , Gg          , Gg          , Ggf         , Gg          , Gg          , Re          , Gg          , Ggf         , Gg          , Gg          , Gg          , Gg          , Ggf         , Gg          , Gg          , Gg          , Ggf         , Gg          , Ggf         , Gg          , Gg          
Hh          , Hh          , Re^Gvs      , Re^Gvs      , Re^Gvs      , Re^Gvs      , Re^Gvs      , Re^Gvs      , Re          , Re          , Re^Gvs      , Re^Gvs      , Re^Gvs      , Re^Gvs      , Re^Gvs      , Re^Gvs      , Gs^Fmf      , Gs^Fdf      , Rr          , Rr          , Gg          , Gg          , Gg          , Ggf         , Ggf         , Gg          , Gg          , Gg          , Ggf         , Gg          , Gg          , Gg          , Gg          , Ggf         , Gg          , Gg          , Gg          , Gg          , Gg          , Gg          , Gg          , Gg          , Gg          
