border_size=1
usage=map

Hh          , Hh          , Hh^Fms      , Hh          , Hh^Fds      , Hh          , Hh^Fds      , Gg          , Gs^Fms      , Gs^Fds      , Gs^Fds      , Gs^Fds      , Gs^Fds      , Gs^Fms      , Gs^Fds      , Gs^Fds      , Gs^Fds      , Gs^Fds      , Gs^Fds      , Gs^Fds      , Gs^Fds      , Gg          , Gs^Fms      , Gs^Fds      , Gs^Fds      , Gs^Fds      , Gs^Fms      
Hh          , Hh^Fds      , Hh          , Hh^Fds      , Hh          , Gs^Fms      , Gs^Fms      , Gs^Fds      , Ggf         , Gs^Fms      , Gs^Fds      , Gs^Fds      , Gs^Fms      , Gs^Fds      , Ggf         , Gs^Fds      , Gg^Fet      , Gs^Fds      , Gs^Fds      , Gs^Fds      , Gs^Fds      , Gs^Fms      , Gs^Fds      , Gs^Fds      , Ggf         , Gs^Fms      , Gs^Fms      
Hh          , Hh^Fds      , Gs^Fms      , Gs^Fms      , Gs^Fms      , Gs^Fds      , Gs^Fds      , Gs^Fds      , Gs^Fms      , Gs^Fds      , Gs^Fds      , Gs^Fds      , Gs^Fds      , Gg^Fet      , Cv          , Cv          , 2 Kv        , Cv          , Cv          , Gg^Fet      , Gs^Fms      , Gs^Fds      , Ggf         , Gs^Fds      , Gs^Fds      , Gs^Fds      , Gs^Fds      
Rp          , Hh^Fms      , Hh^Fms      , Gs^Fms      , Gs^Fms      , Gs^Fds      , Gs^Fms      , Gs^Fds      , Gs^Fds      , Gs^Fms      , Gs^Fds      , Gs^Fms      , Gs^Fms      , Ggf         , Cv          , Rp          , Rp          , Rp          , Cv          , Ggf         , Gs^Fds      , Gs^Fms      , Gs^Fds      , Gs^Fds      , Gs^Fds      , Gs^Fds      , Gs^Fms      
Hh^Fms      , Rp          , Rp          , Gg^Ve       , Gs^Fms      , Gs^Fms      , Gs^Fms      , Ggf         , Rp          , Gs^Fds      , Gs^Fms      , Gs^Fms      , Gs^Fms      , Gg^Fet      , Gs^Fms      , Ggf         , Rp          , Ggf         , Gs^Fds      , Gg^Fet      , Gs^Fms      , Gs^Fds      , Rp          , Gs^Fds      , Gg^Ve       , Gs^Fms      , Rp          
Hh^Fms      , Hh          , Hh^Fds      , Rp          , Rp          , Gs^Fms      , Rp          , Rp          , Gs^Fms      , Rp          , Rp          , Gs^Fds      , Ggf         , Gs^Fp       , Gs^Fds      , Ggf         , Rp          , Ggf         , Gs^Fds      , Gs^Fds      , Rp          , Rp          , Gs^Fds      , Rp          , Rp          , Rp          , Gs^Fms      
Hh^Fds      , Hh^Fds      , Gs^Fms      , Ggf         , Gs^Fms      , Rp          , Gs^Fds      , Gs^Fms      , Gs^Fds      , Ggf         , Gs^Fms      , Rp          , Rp          , Gs^Fds      , Rp          , Rp          , Ggf         , Rp          , Rp          , Rp          , Ss          , Gs^Fms      , Gs^Fms      , Ggf         , Ss          , Gs^Fms      , Ww          
Gs^Fms      , Hh          , Hh^Fds      , Re          , Gs^Fms      , Gs^Fds      , Gs^Fms      , Gs^Fds      , Gs^Fms      , Gs^Fms      , Gs^Fms      , Ggf         , Re          , Rp          , Gs^Fms      , Gs^Fp       , Ss          , Gs^Fms      , Gs^Fms      , Ggf         , Ss^Vhs      , Ss          , Ww          , Ww          , Ww          , Ww          , Ss          
Hh^Fms      , Gs^Fms      , Hh^Fds      , Re^Uf       , Gs^Fms      , Gs^Fms      , Gs^Fms      , Ggf         , Gs^Fds      , Gs^Fms      , Gg^Ve       , Re          , Gs^Fms      , Gs^Fp       , Ss          , Gs^Fds      , Gs^Fds      , Gs^Fms      , Ss          , Ggf         , Ww          , Ww          , Ss          , Ss          , Gs^Fp       , Ww          , Ggf         
Hh^Fms      , Hh          , Hh^Fds      , Hh^Fms      , Hh          , Gs^Fms      , Gs^Fms      , Gs^Fds      , Gs^Fds      , Gs^Fms      , Ss          , Re          , Gs^Fms      , Gs^Fms      , Gs^Fms      , Gs^Fms      , Gs^Fms      , Ww          , Ww          , Ww          , Gg          , Gs^Fp       , Ss          , Gs^Fp       , Gs^Fp       , Ss          , Gs^Fp       
Gs^Fms      , Gs^Fms      , Hh^Fds      , Hh          , Gs^Fms      , Gs^Fms      , Gs^Fms      , Gs^Fms      , Gs^Fms      , Gs^Fms      , Gs^Fms      , Re          , Re          , Gs^Fp       , Gs^Fp       , Gs^Fds      , Ww          , Ww          , Ss          , Ss          , Gs^Fp       , Ss          , Ggf         , Ss          , Ss          , Ss          , Ggf         
Hh^Fds      , Hh^Fds      , Hh          , Hh^Fds      , Hh^Fms      , Hh^Fms      , Hh          , Ggf         , Ggf         , Gs^Fds      , Gs^Fms      , Gg          , Gg          , Re          , Re          , Ss          , Ww          , Ss          , Gg          , Gs^Fp       , Ggf         , Ss          , Gs^Fp       , Gs^Fp       , Ss          , Ggf         , Gs^Fp       
Hh^Fds      , Hh^Fds      , Hh^Fds      , Hh^Fms      , Hh^Fms      , Hh^Fms      , Gs^Fms      , Gs^Fms      , Gs^Fms      , Gs^Fms      , Gs^Fms      , Gs^Fms      , Ggf         , Re          , Ss          , Ggf         , Ww          , Gs^Fp       , Ss          , Re^Uf       , Ss          , Ggf         , Ss          , Ss          , Gs^Fp       , Ss^Vhs      , Gs^Fp       
Hh          , Hh^Fds      , Hh^Fds      , Hh^Fds      , Hh^Fds      , Hh^Fds      , Gs^Fms      , Gs^Fms      , Gs^Fds      , Gs^Fms      , Gs^Fms      , Ggf         , Gs^Fds      , Re          , Gs^Fp       , Ww          , Gg^Fet      , Ww          , Ss          , Ss          , Ss          , Gs^Fp       , Gs^Fp       , Ggf         , Gs^Fp       , Gs^Fp       , Gs^Fp       
Hh          , Hh          , Hh^Fds      , Hh^Fms      , Hh^Fms      , Hh          , Gs^Fds      , Gs^Fds      , Re          , Gs^Fms      , Ggf         , Ggf         , Re          , Re          , Gs^Fp       , Ww          , Ww          , Ww          , Ww          , Ggf         , Ss          , Ggf         , Ss          , Ggf         , Gs^Fp       , Gs^Fp       , Gs^Fp       
Hh^Fds      , Hh^Fds      , Hh          , Hh^Fms      , Hh          , Hh^Fds      , Re          , Re          , Gs^Fds      , Ggf         , Gg^Ve       , Gg          , Re          , Gg          , Ww          , Ww          , Ss          , Ss^Vhs      , Gs^Fp       , Gs^Fp       , Ss          , Ggf         , Ss          , Ss          , Re^Uf       , Gs^Fp       , Gs^Fp       
Hh^Fds      , Gg^Ve       , Re          , Re          , Re          , Gs^Fds      , Ggf         , Gs^Fms      , Gs^Fds      , Hh          , Gs^Fms      , Re          , Re          , Gs^Fp       , Ww          , Gs^Fds      , Gs^Fms      , Ggf         , Ss          , Ss          , Gs^Fp       , Ss          , Ggf         , Ss          , Ss          , Gs^Fp       , Gs^Fp       
Hh^Fms      , Gs^Fds      , Hh^Fds      , Hh^Fds      , Gs^Fms      , Re          , Gs^Fds      , Gs^Fms      , Hh^Fds      , Hh^Fds      , Hh          , Ggf         , Re          , Ss          , Ww          , Ss          , Gs^Fp       , Re^Uf       , Ss          , Ggf         , Gs^Fp       , Ggf         , Gs^Fp       , Gs^Fp       , Ss          , Ggf         , Ss          
Hh^Fds      , Hh^Fds      , Hh^Fds      , Hh          , Gs^Fds      , Gs^Fds      , Gs^Fds      , Gs^Fds      , Hh          , Hh^Fds      , Ggf         , Gs^Fms      , Re          , Gs^Fp       , Ss          , Ww          , Ss          , Ss          , Gg          , Ss          , Ggf         , Ss          , Ggf         , Ss          , Ss          , Gs^Fp       , Ggf         
Hh^Fds      , Hh^Fds      , Hh^Fds      , Hh          , Gs^Fds      , Ggf         , Gs^Fds      , Gs^Fms      , Gs^Fms      , Hh^Fds      , Gs^Fms      , Ggf         , Re          , Gs^Fms      , Ss          , Ww          , Ww          , Ss          , Ss          , Ss          , Gs^Fp       , Gs^Fp       , Ss          , Ggf         , Ss          , Gs^Fp       , Ss          
Hh          , Hh^Fms      , Gs^Fds      , Gs^Fds      , Gs^Fms      , Gs^Fds      , Gs^Fds      , Gs^Fds      , Gs^Fds      , Gs^Fds      , Ggf         , Gg          , Ggf         , Re          , Re          , Ggf         , Ss          , Ww          , Ww          , Ggf         , Ss          , Ss          , Gs^Fp       , Ss          , Ggf         , Ss          , Gs^Fp       
Gs^Fds      , Gs^Fds      , Ggf         , Gs^Fds      , Gs^Fms      , Gs^Fds      , Hh          , Gs^Fds      , Hh^Fds      , Gs^Fds      , Hh          , Hh          , Gs^Fms      , Gs^Fds      , Ggf         , Re          , Re          , Gs^Fms      , Gs^Fms      , Ww          , Ww          , Ss          , Ss          , Ss^Vhs      , Gs^Fp       , Re^Uf       , Gs^Fp       
Gs^Fds      , Gs^Fds      , Gs^Fms      , Gs^Fds      , Gs^Fds      , Ggf         , Gs^Fds      , Hh^Fds      , Hh^Fds      , Hh^Fds      , Gs^Fds      , Gg          , Gs^Fds      , Gs^Fds      , Gg^Ve       , Gs^Fms      , Gs^Fds      , Re          , Gs^Fms      , Ss          , Ss          , Ww          , Ww          , Ss          , Gs^Fp       , Gs^Fp       , Ggf         
Gs^Fms      , Hh^Fds      , Hh^Fds      , Gs^Fms      , Gs^Fds      , Gs^Fms      , Gs^Fds      , Hh^Fds      , Gs^Fds      , Gs^Fds      , Gs^Fds      , Gs^Fds      , Gs^Fms      , Gs^Fds      , Gs^Fds      , Gs^Fds      , Ggf         , Re          , Gs^Fds      , Gs^Fp       , Gs^Fp       , Ss          , Gs^Fp       , Ww          , Ww          , Ss          , Gs^Fp       
Gs^Fms      , Hh^Fds      , Hh^Fds      , Hh          , Gs^Fds      , Gs^Fms      , Gs^Fms      , Gs^Fds      , Ggf         , Gs^Fms      , Gs^Fms      , Gs^Fms      , Gs^Fms      , Gs^Fds      , Gs^Fms      , Gs^Fds      , Re          , Re          , Gs^Fms      , Gs^Fms      , Gs^Fds      , Gs^Fms      , Gs^Fp       , Ss          , Gs^Fp       , Ww          , Ww          
Gs^Fms      , Gs^Fds      , Gs^Fds      , Gs^Fds      , Ggf         , Gs^Fds      , Gs^Fds      , Gs^Fds      , Gs^Fms      , Gs^Fds      , Gs^Fds      , Gs^Fds      , Gs^Fds      , Gs^Fms      , Re          , Re          , Re          , Gs^Fds      , Gs^Fds      , Gs^Fms      , Gs^Fds      , Gs^Fms      , Gs^Fms      , Gs^Fms      , Re^Uf       , Ss          , Gs^Fms      
Gs^Fms      , Gs^Fds      , Gs^Fds      , Gs^Fds      , Gs^Fds      , Gs^Fds      , Gs^Fds      , Gs^Fds      , Gs^Fds      , Gs^Fds      , Gs^Fms      , Gs^Fms      , Re          , Re          , Re          , Re          , Re          , Re          , Re          , Re          , Re          , Gs^Fds      , Gs^Fds      , Gs^Fds      , Gs^Fds      , Gs^Fds      , Gs^Fds      
Gs^Fds      , Gs^Fds      , Gg^Ve       , Gs^Fms      , Gs^Fds      , Gs^Fds      , Gs^Fds      , Gs^Fds      , Gs^Fp       , 3 Re        , Re          , Re          , Re          , Gg^Fet      , Ce          , Ce          , Ce          , Re          , Gs^Fms      , Ggf         , Gs^Fds      , Re          , Re          , Gg^Ve       , Re          , Gs^Fds      , Gs^Fds      
Gs^Fds      , Gs^Fms      , Ggf         , Gs^Fds      , Re          , Gs^Fds      , Re          , Gs^Fds      , Re          , Re          , Gs^Fds      , Re          , Re          , Re          , 1 Ke        , Ce          , Ce          , Re          , Gs^Fms      , Gs^Fds      , Gs^Fds      , Gs^Fds      , Gs^Fds      , Re          , Re          , Re          , Re          
Gs^Fds      , Gs^Fds      , Re          , Re          , Gs^Fms      , Re          , Re          , Re          , Gs^Fms      , Gs^Fms      , Gs^Fds      , Gg^Ve       , Gs^Fds      , Re          , Re          , Ce          , Re          , Re          , Gs^Fds      , Gs^Fds      , Gs^Fms      , Gs^Fds      , Gs^Fms      , Gs^Fds      , Gs^Fds      , Gs^Fds      , Gs^Fds      
Gs^Fms      , Gs^Fds      , Re          , Gs^Fds      , Gs^Fds      , Gs^Fds      , Gs^Fms      , Gs^Fds      , Gs^Fds      , Gs^Fms      , Gs^Fds      , Gs^Fds      , Gs^Fds      , Gs^Fds      , Gs^Fms      , Re          , Gs^Fds      , Gs^Fms      , Gs^Fms      , Gs^Fds      , Gs^Fms      , Gs^Fms      , Gs^Fds      , Gs^Fms      , Gs^Fds      , Gs^Fms      , Gs^Fds      
Gs^Fds      , Gs^Fds      , Re          , Gs^Fds      , Gs^Fds      , Gs^Fms      , Gs^Fds      , Gs^Fds      , Gs^Fms      , Gs^Fds      , Gs^Fds      , Gs^Fms      , Gs^Fds      , Gs^Fms      , Gs^Fds      , Gs^Fds      , Gs^Fds      , Gs^Fms      , Gs^Fds      , Gs^Fds      , Gs^Fms      , Gs^Fms      , Gs^Fds      , Gs^Fds      , Gs^Fms      , Gs^Fms      , Gs^Fds      
