border_size=1
usage=map

Mm          , Mm          , Mm          , Gs^Fp       , Hh^Fp       , Hh^Fp       , Gs^Fp       , Gs^Fp       , Gs^Fp       , Re          , Re          , Gs^Fp       , Gs^Fp       , Gs^Fp       , Gs^Fp       , Gs^Fp       , Gs^Fp       , Gs^Fp       , Gs^Fp       , Gs^Fp       , Ss^Uf       , Ss          , Ww          , Ww          , Ww          , Ww          , Ww          , Ww          , Ww          , Ww          , Ww          , Ww          , Ww          , Ss          , Ggf         , Ss          , Ss          , Ss          , Ggf         , Ss          , Ss          , Ss          , Gs^Fp       , Gs^Fp       , Gs^Fp       , Gs^Fp       , Ggf         , Gs^Fp       , Gs^Fp       , Gs^Fp       , Gs^Fp       , Gs^Fp       
Mm          , Mm          , Mm          , Mm          , Hh^Fmw      , Hh^Fp       , Gs^Fp       , Gs^Fp       , Gs^Fmw      , Gs^Fp       , Gs^Fp       , Re          , Re          , Gs^Fmw      , Gs^Fp       , Gs^Fp       , Gs^Fmw      , Gs^Fp       , Gs^Fmw      , Gs^Fp       , Gs^Fp       , Ss^Uf       , Ss          , Ww          , Ww          , Ww          , Ww          , Ww          , Ww          , Ww          , Ww          , Ww          , Ww          , Ww          , Ss          , Ss          , Gs^Fp       , Ss          , Ss          , Ss          , Gs^Fp       , Ss          , Ss          , Gs^Fp       , Ggf         , Gs^Fp       , Gs^Fp       , Gs^Fmw      , Gs^Fp       , Gs^Fmw      , Gs^Fp       , Gs^Fmw      
Mm          , Mm          , Mm          , Mm          , Mm          , Hh^Fp       , Hh^Fp       , Gs^Fp       , Gs^Fp       , Gs^Fp       , Gs^Fmw      , Gs^Fp       , Gs^Fmw      , Re          , Gg^Vh       , Gs^Fp       , Gs^Fp       , Gs^Fp       , Gs^Fp       , Gs^Fp       , Gs^Fp       , Gs^Fmw      , Ss          , Ww          , Ww          , Ww          , Ww          , Ww          , Ww          , Ww          , Ww          , Ww          , Ww          , Ggf         , Ss          , Gs^Fp       , Ggf         , Ss          , Gs^Fp       , Ss          , Ss          , Ss          , Gs^Fp       , Gs^Fp       , Gs^Fp       , Gs^Fp       , Ggf         , Gs^Fp       , Gs^Fp       , Gs^Fp       , Gs^Fp       , Gs^Fp       
Mm          , Mm          , Mm          , Mm          , Mm          , Mm          , Hh^Vc       , Gs^Fp       , Gs^Fmw      , Gs^Fp       , Gs^Fp       , Gs^Fp       , Gs^Fp       , Re          , Re          , Gg^Vh       , Gs^Fp       , Gs^Fp       , Gs^Fmw      , Gs^Fp       , Gs^Fp       , Ss          , Ww          , Ww          , Ww          , Ww          , Ww          , Ww          , Ww          , Ww          , Ss          , Ggf         , Ss          , Ss          , Ss          , Ss          , Ss          , Ss          , Ss          , Ss          , Gg          , Ggf         , Gs^Fmw      , Gs^Fp       , Ggf         , Gs^Fmw      , Gs^Fp       , Ggf         , Gs^Fp       , Gs^Fp       , Gs^Fmw      , Gs^Fp       
Mm          , Mm          , Mm          , Mm          , Mm          , Mm          , Hh^Fp       , Hh^Fmw      , Gs^Fp       , Gs^Fmw      , Gs^Fp       , Gs^Fmw      , Re          , Re          , Ggf         , Re          , Re          , Gs^Fmw      , Gs^Fp       , Gs^Fp       , Gs^Fmw      , Ss          , Ds          , Gs^Fp       , Gg^Vh       , Ds          , Ds          , Ww          , Ggf         , Ss          , Ss^Uf       , Ggf         , Ss          , Ss          , Ggf         , Ss^Uf       , Ss^Uf       , Ss          , Ggf         , Ss          , Ggf         , Gg          , Ggf         , Ggf         , Gs^Fp       , Gs^Fmw      , Gs^Fp       , Ggf         , Gs^Fp       , Gs^Fp       , Gs^Fmw      , Gs^Fp       
Mm          , Mm          , Mm          , Mm          , Mm          , Hh^Fp       , Hh^Fp       , Gs^Fp       , Gs^Fp       , Gs^Fmw      , Re          , Re          , Ggf         , Ggf         , Ce          , Ggf         , Gg          , Re          , Re          , Gs^Fp       , Gg          , Gg          , Re          , Re          , Gg          , Gg          , Gs^Fp       , Ggf         , Ggf         , Gs^Fp       , Ss^Uf       , Ss          , Gs^Fp       , Ww          , Ss          , Ss^Uf       , Ss          , Ss          , Ggf         , Ggf         , Gs^Fp       , Ggf         , Ggf         , Gs^Fmw      , Ggf         , Gs^Fp       , Gs^Fp       , Gs^Fmw      , Gs^Fp       , Gs^Fp       , Gs^Fp       , Gs^Fp       
Ww          , Mm          , Mm          , Mm          , Hh^Fp       , Hh^Fmw      , Gs^Fp       , Gs^Fp       , Gs^Fp       , Re          , Ggf         , Ggf         , Gs^Fp       , Ce          , Ke          , Ce          , Hh          , Gs^Fp       , Hh^Fp       , Re          , Re          , Re          , Ggf         , Re          , Gg          , Gs^Fmw      , Gs^Fp       , Gs^Fp       , Gs^Fmw      , Gs^Fp       , Gs^Fmw      , Ss^Uf       , Ww          , Ww          , Ggf         , Ss          , Ggf         , Gs^Fp       , Ss          , Ss          , Gs^Fp       , Gg          , Gs^Fp       , Gs^Fp       , Ggf         , Ggf         , Gs^Fp       , Gs^Fp       , Ggf         , Gs^Fp       , Gs^Fp       , Gs^Fp       
Mm          , Ww          , Ww          , Ww          , Ww          , Gs^Fp       , Gs^Fp       , Gs^Fmw      , Gs^Fp       , Re          , Gg^Vh       , Ggf         , Ggf         , Ce          , Ce          , Ce          , Hh^Fp       , Mm          , Mm          , Hh          , Hh^Fp       , Hh^Fp       , Gs^Fp       , Re          , Re          , Gs^Fp       , Gs^Fmw      , Gs^Fp       , Gs^Fp       , Gs^Fp       , Gs^Fp       , Ss          , Ww          , Gs^Fp       , Gs^Fp       , Gs^Fp       , Gs^Fp       , Ggf         , Ss          , Ss          , Ggf         , Ss          , Gg          , Gs^Fp       , Gs^Fp       , Gs^Fmw      , Ggf         , Gs^Fp       , Gs^Fmw      , Gs^Fp       , Gs^Fp       , Gs^Fmw      
Mm          , Mm          , Mm          , Mm          , Hh^Fmw      , Ww          , Ww          , Gs^Fp       , Gs^Fp       , Re          , Re          , Ggf         , Gs^Fp       , Ggf         , Gs^Fp       , Gs^Fmw      , Hh          , Hh          , Mm          , Ss          , Mm          , Hh^Fp       , Hh^Fp       , Gs^Fp       , Gs^Fp       , Re          , Re          , Gs^Fp       , Dd          , Gs^Fp       , Ggf         , Ww          , Gg^Vh       , Ww          , Ss^Uf       , Gs^Fp       , Ss^Uf       , Ss          , Gs^Fmw      , Gg          , Ss          , Ggf         , Gs^Fmw      , Gs^Fp       , Gs^Fp       , Gs^Fmw      , Ggf         , Gs^Fp       , Gs^Fp       , Gs^Fp       , Gs^Fp       , Gs^Fp       
Mm          , Mm          , Mm          , Hh^Fp       , Hh^Fp       , Ww          , Ww          , Gs^Fp       , Ww          , Ss          , Ss^Bw|      , Ss          , Ss          , Gs^Fmw      , Gs^Fp       , Gs^Fp       , Hh^Fmw      , Mm          , Mm          , Mm          , Mm          , Hh          , Hh^Fp       , Ggf         , Gs^Fp       , Gs^Fmw      , Gs^Fp       , Re          , Re          , Re          , Re          , Ww^Bw/      , Ww          , Ww^Bw\      , Ss^Bw|      , Ss          , Gs^Fmw      , Gs^Fp       , Ss          , Ss          , Gs^Fp       , Gs^Fp       , Ss          , Ss          , Gs^Fp       , Gs^Fp       , Gs^Fp       , Gs^Fp       , Gs^Fmw      , Ggf         , Gs^Fp       , Gs^Fp       
Mm          , Mm          , Mm          , Hh^Fp       , Hh^Vc       , Hh^Fp       , Ss          , Ww          , Ss          , Ww          , Ss^Bw/      , Ww          , Ww          , Ss          , Ww          , Ggf         , Hh^Fp       , Hh^Fp       , Hh^Fp       , Mm          , Mm          , Hh^Fp       , Hh          , Hh^Fp       , Hh^Fp       , Gs^Fp       , Re          , Re          , Ss          , Gs^Fp       , Ss          , Ww          , Ww          , Ss^Uf       , Re          , Gs^Fmw      , Ss          , Gs^Fp       , Gs^Fmw      , Ss          , Ggf         , Gs^Fmw      , Ss          , Gs^Fp       , Ggf         , Gs^Fp       , Gs^Fp       , Gs^Fp       , Gs^Fmw      , Gs^Fmw      , Gs^Fmw      , Gs^Fp       
Mm          , Mm          , Mm          , Mm          , Hh^Fmw      , Hh^Fp       , Gs^Fmw      , Ss          , Gs^Fmw      , Re          , Re          , Ss          , Gs^Fp       , Ww          , Ww          , Ss          , Gs^Fp       , Hh^Fp       , Hh          , Mm          , Mm          , Mm          , Mm          , Hh^Vc       , Hh          , Hh^Fp       , Re          , Gs^Fp       , Ss^Uf       , Ww          , Ww          , Ww          , Ww          , Gs^Fp       , Ss          , Re          , Re          , Ss          , Ss          , Gg          , Gs^Fp       , Gg          , Gs^Fp       , Ggf         , Ggf         , Gg          , Co          , Co          , Co          , Gs^Fp       , Gs^Fp       , Gs^Fp       
Mm          , Mm          , Hh^Fp       , Hh^Fmw      , Gs^Fp       , Hh^Fp       , Gs^Fp       , Gs^Fp       , Gs^Fp       , Ss          , Re          , Gs^Fmw      , Gs^Fp       , Gs^Fp       , Gs^Fp       , Ww          , Ww          , Ss^Vhs      , Mm          , Mm          , Mm          , Mm          , Hh          , Mm          , Hh^Fp       , Hh          , Re          , Gs^Fp       , Ss^Uf       , Ss          , Ww          , Gs^Fp       , Ww          , Ww          , Gs^Fp       , Gg          , Re          , Ss          , Gg          , Ggf         , Gg          , Ggf         , Ggf         , Gg          , Ggf         , Co          , Co          , 2 Ko        , Co          , Co          , Gs^Fp       , Gs^Fp       
Mm          , Mm          , Hh^Fp       , Hh^Fp       , Gs^Fmw      , Gs^Fp       , Gs^Fp       , Gs^Fmw      , Re          , Re          , Gs^Fp       , Gs^Fp       , Gs^Fmw      , Gs^Fp       , Gs^Fp       , Ww          , Hh^Fp       , Ww          , Ww          , Mm          , Mm          , Mm          , Mm          , Mm          , Hh^Fmw      , Re          , Gs^Fp       , Gs^Fp       , Gs^Fp       , Gs^Fp       , Ww          , Ww          , Ww          , Ss^Uf       , Gs^Fp       , Gg          , Ggf         , Re          , Re          , Ggf         , Ggf         , Ggf         , Gs^Fp       , Ggf         , Gs^Fmw      , Gg          , Ggf         , Co          , Gs^Fp       , Gs^Fp       , Gs^Fmw      , Gs^Fmw      
Hh^Fp       , Hh^Fmw      , Gs^Fp       , Gs^Fp       , Gs^Fmw      , Gs^Fp       , Re          , Re          , Gs^Fp       , Gs^Fmw      , Gs^Fp       , Gs^Fp       , Gs^Fp       , Gs^Fmw      , Gs^Fp       , Gs^Fp       , Hh^Fmw      , Hh^Fp       , Ww          , Hh          , Hh^Fp       , Mm          , Hh          , Hh          , Hh^Vhh      , Re          , Re          , Gs^Fp       , Gs^Fp       , Ss^Uf       , Gs^Fp       , Ww          , Ww          , Ss          , Gs^Fp       , Gs^Fp       , Ggf         , Ggf         , Gs^Fp       , Re          , Re          , Gs^Fmw      , Gs^Fmw      , Gs^Fp       , Gs^Fp       , Ggf         , Re          , Re          , Gs^Fmw      , Ggf         , Re          , Re          
Gs^Fp       , Gs^Fmw      , Re          , Re          , Re          , 1 Re        , Gs^Fp       , Gs^Fp       , Gs^Fmw      , Gs^Fp       , Gs^Fp       , Gs^Fp       , Gs^Fp       , Gs^Fp       , Gs^Fp       , Gs^Fmw      , Gs^Fp       , Mm          , Ww          , Mm          , Mm          , Hh^Fmw      , Hh          , Hh^Fp       , Hh^Fmw      , Hh^Fmw      , Hh^Fp       , Re          , Gs^Fp       , Gs^Fp       , Gs^Fp       , Ww          , Gs^Fp       , Gs^Fp       , Gs^Fp       , Gs^Fp       , Gs^Fp       , Ggf         , Gg          , Gg          , Ggf         , Re          , Re          , Gs^Fp       , Re          , Re          , Gg          , Re          , Re          , Re          , Ggf         , Ggf         
Gs^Fp       , Re          , Gs^Fp       , Gs^Fp       , Gs^Fp       , Gs^Fp       , Gs^Fp       , Gs^Fp       , Gs^Fp       , Gs^Fp       , Gs^Fp       , Gs^Fmw      , Gs^Fp       , Hh          , Hh^Fp       , Hh^Fp       , Hh^Vc       , Ww          , Mm          , Ww          , Ww          , Mm          , Ww          , Ww          , Ww          , Hh^Fp       , Ww          , Ww^Bw|      , Ww          , Gs^Fp       , Gs^Fmw      , Ww          , Ss          , Gs^Fmw      , Gs^Fp       , Gs^Fp       , Gs^Fmw      , Gs^Fmw      , Gs^Fp       , Gg          , Gs^Fp       , Ggf         , Gs^Fmw      , Re          , Re          , Gg^Vo       , Ggf         , Gg          , Ggf         , Ggf         , Ggf         , Ggf         
Re          , Re          , Gs^Fp       , Gs^Fmw      , Gs^Fp       , Gs^Fp       , Gs^Fmw      , Gs^Fp       , Gs^Fmw      , Gs^Fp       , Gs^Fp       , Gs^Fp       , Hh^Fp       , Hh^Fmw      , Mm          , Mm          , Mm          , Hh          , Hh          , Mm          , Mm          , Ww          , Mm          , Mm          , Hh^Fp       , Ww          , Hh          , Re          , Hh          , Ww          , Ww          , Ww          , Gs^Fp       , Gs^Fp       , Gs^Fmw      , Gs^Fp       , Ss          , Gs^Fp       , Gs^Fmw      , Gs^Fp       , Gs^Fp       , Gs^Fp       , Gs^Fp       , Gs^Fp       , Gs^Fmw      , Re          , Gs^Fp       , Gs^Fp       , Gs^Fp       , Gs^Fp       , Gs^Fp       , Gs^Fmw      
Gs^Fp       , Gs^Fp       , Gs^Fmw      , Gs^Fp       , Gs^Fp       , Gs^Fp       , Gs^Fp       , Gs^Fp       , Gs^Fp       , Gs^Fp       , Gs^Fmw      , Hh          , Hh^Fp       , Hh^Fp       , Mm          , Mm          , Mm          , Mm          , Mm          , Hh          , Mm          , Mm          , Mm          , Mm          , Hh          , Hh          , Re          , Re          , Hh^Fp       , Hh          , Hh          , Ww          , Ww          , Gs^Fmw      , Gs^Fp       , Gs^Fp       , Ss          , Ss          , Gs^Fp       , Gs^Fp       , Gs^Fmw      , Gs^Fp       , Gs^Fmw      , Gs^Fp       , Gs^Fp       , Re          , Re          , Gs^Fmw      , Gs^Fp       , Gs^Fp       , Gs^Fp       , Gs^Fmw      
Gs^Fmw      , Gs^Fp       , Gs^Fp       , Gs^Fp       , Gs^Fp       , Gs^Fmw      , Gs^Fp       , Gs^Fp       , Gs^Fmw      , Gs^Fp       , Hh^Fp       , Hh^Fp       , Mm          , Mm          , Mm          , Mm          , Mm          , Mm          , Mm          , Hh          , Hh          , Mm          , Mm          , Hh^Vc       , Hh          , Re          , Hh          , Hh          , Hh^Vhh      , Hh          , Hh          , Hh^Fp       , Ww          , Ww          , Ww          , Gs^Fmw      , Ww          , Gs^Fp       , Gs^Fmw      , Gs^Fp       , Gs^Fp       , Gs^Fp       , Gs^Fp       , Gs^Fp       , Gs^Fmw      , Gs^Fmw      , Gs^Fp       , Re          , Gs^Fp       , Gs^Fmw      , Gs^Fp       , Gs^Fp       
Gs^Fp       , Gs^Fp       , Gs^Fmw      , Gs^Fp       , Gs^Fp       , Gs^Fp       , Gs^Fmw      , Gs^Fp       , Gs^Fp       , Gs^Fmw      , Hh^Fp       , Hh^Fmw      , Hh^Fp       , Mm          , Mm          , Mm          , Mm          , Mm          , Mm          , Mm          , Mm          , Mm          , Mm          , Hh^Fp       , Hh^Fp       , Re          , Re          , Hh^Fmw      , Hh          , Hh^Fp       , Hh          , Hh          , Hh          , Hh^Fp       , Hh^Fmw      , Ww          , Ww          , Gs^Fp       , Gs^Fp       , Gs^Fp       , Gs^Fmw      , Gs^Fp       , Gs^Fmw      , Gs^Fp       , Gs^Fp       , Gs^Fp       , Re          , Re          , Gs^Fmw      , Gs^Fp       , Gs^Fmw      , Gs^Fp       
Gs^Fp       , Gs^Fmw      , Gs^Fp       , Gs^Fmw      , Gs^Fp       , Gs^Fp       , Gs^Fp       , Gs^Fp       , Gs^Fp       , Hh^Fp       , Hh          , Hh^Fp       , Hh^Fp       , Mm          , Mm          , Mm          , Mm          , Mm          , Mm          , Mm          , Mm          , Mm          , Mm          , Mm          , Hh^Fp       , Hh          , Hh^Fp       , Re          , Re          , Hh          , Gs^Fp       , Hh^Fp       , Hh^Fp       , Hh^Fp       , Hh^Fmw      , Hh^Fp       , Hh^Fp       , Ww          , Ww          , Gs^Fp       , Gs^Fp       , Gs^Fp       , Gs^Fp       , Gs^Fp       , Gs^Fp       , Gs^Fmw      , Re          , Gs^Fmw      , Gs^Fp       , Gs^Fp       , Gs^Fp       , Gs^Fmw      
