border_size=1
usage=map

Wo          , Wo          , Ww          , Ww          , Ww          , Wwr         , Mm          , Mm          , Mm          , Mm          , Gs^Fds      , Gg          , Gs^Fds      , Gg          , Gs^Fds      , Gg          , Gs^Fds      , Gg          , Gg          , Gg          , Gg          , Gg          , Gg          , Ss          , Ss          , Ch          , Ch          , Gs^Fds      , Gs^Fds      , Gs^Fds      , Gs^Fds      , Gs^Fds      , Gs^Fds      , Re          , Gs^Fds      , Gs^Fds      , Gs^Fds      
Wo          , Wo          , Ww          , Ww          , Ww          , Wwr         , Mm          , Mm          , Mm          , Mm          , Gs^Fds      , Gs^Fds      , Gs^Fds      , Gs^Fds      , Gs^Fds      , Gs^Fds      , Gg          , Gg          , Re^Gvs      , Re^Gvs      , Re^Gvs      , Gg          , Gg          , Gg          , Gg          , Ss          , Gg          , Chr         , Chr         , Gs^Fds      , Gs^Fds      , Gs^Fds      , Ggf         , 2 Re        , Ggf         , Gs^Fds      , Gs^Fds      
Wo          , Wo          , Ww          , Ww          , Ww          , Wwr         , Wwr         , Mm          , Mm          , Mm          , Ww          , Ww          , Ww          , Ds          , Rr          , Rr          , Rr          , Gg          , Gg          , Re^Gvs      , Re^Gvs      , Re^Gvs      , Gg^Wm       , Gg          , Re^Gvs      , Gg          , Gg          , Gg          , Gg          , Ch          , Ch          , Gs^Fds      , Rr          , Rr          , Ggf         , Gs^Fds      , Gs^Fds      
Wo          , Wo          , Wo          , Ww          , Ww          , Wwr         , Ggf         , Gs^Fds      , Gs^Fds      , Ww          , Ww          , Ww          , Ww          , Ww^Bw/      , Ww          , Re          , Rr          , Rr          , Rr          , Gg          , Ggf         , Gg          , Ggf         , Re^Gvs      , Re^Gvs      , Re^Gvs      , Re^Gvs      , Gg          , Gg          , Ch          , Rr          , Rr          , Ch          , Ggf         , Gs^Fds      , Gs^Fds      , Gs^Fds      
Wo          , Wo          , Wo          , Ww          , Ww          , Ww          , Ggf         , Ggf         , Ww          , Ww          , Ww          , Ww          , Ww          , Ww          , Ww          , Ww^Bw/      , Ww          , Gs^Fds      , Gs^Fds      , Rr          , Rr          , Ggf         , Ggf         , Ggf         , Gg          , Re^Gvs      , Gg          , Gg          , Rr          , Re          , Gg          , Ch          , Ch          , Gs^Fds      , Gs^Fds      , Gs^Fds      , Gs^Fds      
Wo          , Wo          , Wo          , Ww          , Ww          , Ww          , Ww          , Ww          , Ww          , Ww          , Ww          , Ww          , Ww          , Ww          , Ww          , Ww          , Ww          , Ww          , Gs^Fds      , Gs^Fds      , Gs^Fds      , Rr          , Gg          , Ggf         , Gs^Fds      , Ggf         , Rr          , Rr          , Gg          , Gg          , Ggf         , Ss          , Ss          , Chr         , Gg          , Gs^Fds      , Gs^Fds      
Wo          , Wo          , Wo          , Wo          , Ww          , Ww          , Ww          , Ww          , Ww          , Ww          , Ww          , Ww          , Ww          , Ww          , Ww          , Ww          , Ww          , Ww          , Ss          , Gs^Fds      , Ggf         , Rr          , Rr          , Gg^Fet      , Rr          , Ds          , Rr          , Ss          , Ss          , Gs^Fms      , Ggf         , Gg          , Ss          , Chr         , Gs^Fds      , Gs^Fds      , Gs^Fds      
Wo          , Wo          , Wo          , Wo          , Wo          , Ww          , Wo          , Ww          , Wo          , Ww          , Ww          , Ww          , Ww          , Ww          , Ww          , Ww          , Ww          , Ww          , Gg          , Ss          , Gs^Fds      , Gg          , Rp^Vhc      , Rr          , Rp^Vhc      , Gs^Fds      , Rp^Vhc      , Rr          , Rr          , Ggf         , Ggf         , Gg          , Gg          , Chr         , Gs^Fds      , Gs^Fds      , Gs^Fds      
Wo          , Wo          , Wo          , Wo          , Wo          , Wo          , Wo          , Wo          , Wo          , Wo          , Ww          , Ww          , Ww          , Ww          , Ww          , Ww          , Ww          , Gg          , Ww          , Ww          , Ww          , Ww          , Ds          , Rr          , Gs^Fds      , Re          , Ww          , Gs^Fds      , Gs^Fds      , Rr          , Gg          , Ggf         , Gg          , Ch          , Gg          , Gs^Fds      , Gs^Fds      
Wo          , Wo          , Wo          , Wo          , Wo          , Wo          , Wo          , Wo          , Wo          , Wo          , Ww          , Ww          , Ww          , Ww          , Ww          , Ww          , Ww          , Ww          , Ww          , Ww          , Ss          , Ww          , Rp^Vhc      , Rr          , Rp^Vhc      , Gs^Fds      , Rp^Vhc      , Gs^Fds      , Re          , Rr          , Rr          , Gg          , Ch          , Ch          , Gs^Fds      , Gs^Fds      , Gs^Fds      
Wo          , Wo          , Wo          , Wo          , Wo          , Wo          , Wo          , Wo          , Wo          , Wo          , Ww          , Ww          , Ww          , Ww          , Wwr         , Ww          , Ww          , Ww          , Ww          , Ss          , Ggf         , Gg          , Rr          , Rr          , Rr          , Gs^Fds      , Rr          , Rr          , Ggf         , Ggf         , Ggf         , Rr          , Rr          , Ch          , Gs^Fds      , Gs^Fds      , Gs^Fds      
Wo          , Wo          , Wo          , Wo          , Wo          , Wo          , Wo          , Wo          , Wo          , Ww          , Ww          , Ww          , Ww          , Wwr         , Mm          , Wwr         , Gs^Fds      , Ww          , Ss          , Gs^Fds      , Re          , Rr          , Ggf         , Gg          , Gg          , Re          , Gg          , Ggf         , Gg          , Gs^Fms      , Gg          , Ggf         , Ch          , Rr          , Rr          , Gs^Fds      , Re          
Wo          , Wo          , Wo          , Wo          , Wo          , Wo          , Wo          , Wo          , Ww          , Ww          , Ww          , Ww          , Wwr         , Wwr         , Mm          , Mm          , Ss          , Ss          , Gg          , Gg          , Rr          , Rr          , Ggf         , Gs^Fds      , Gs^Fds      , Gg          , Gs^Fds      , Ss          , Ss          , Gg          , Ss          , Gg          , Ch          , Chr         , Gs^Fds      , Rr          , Gs^Fms      
Wo          , Wo          , Wo          , Wo          , Wo          , Wo          , Ww          , Ww          , Ww          , Ww          , Ww          , Wwr         , Wwr         , Mm          , Mm          , Gs^Fds      , Gs^Fds      , Gs^Fds      , Gg^Vh       , Ggf         , Rr          , Gg          , Gs^Fds      , Ss          , Ch          , Chr         , Chr         , Ss          , Ww          , Ss          , Chr         , Ch          , Ss          , Gg          , Gs^Fds      , Gs^Fms      , Gs^Fms      
Wo          , Wo          , Wo          , Wo          , Wo          , Ww          , Ww          , Ww          , Ww          , Ww          , Wwr         , Wwr         , Mm          , Mm          , Mm          , Mm          , Gs^Fds      , Gs^Fds      , Gs^Fds      , Ggf         , Rr          , Gg          , Ch          , Ch          , Gs^Fds      , Ss          , Gs^Fds      , Chw         , Chr         , Chr         , Gs^Fds      , Ss          , Gs^Fds      , Gs^Fds      , Gs^Fms      , Gs^Fms      , Gs^Fms      
Wo          , Wo          , Wo          , Wo          , Wo          , Ww          , Ww          , Ww          , Ww          , Wwr         , Wwr         , Mm          , Mm          , Mm          , Mm          , Mm          , Mm          , Gs^Fds      , Gs^Fds      , Ggf         , Ch          , Rr          , Rr          , Ch          , Gs^Fds      , Gs^Fds      , Gs^Fds      , Gs^Fds      , Gs^Fds      , Ss          , Gs^Fds      , Gs^Fds      , Gs^Fds      , Gs^Fms      , Gs^Fms      , Gs^Fp       , Gs^Fms      
Wo          , Wo          , Wo          , Wo          , Wo          , Ww          , Ww          , Ww          , Wwr         , Wwr         , Mm          , Mm          , Mm          , Mm          , Mm          , Mm          , Mm          , Mm          , Gs^Fds      , Gs^Fds      , Ch          , Ch          , Gg          , Re          , Ggf         , Gs^Fds      , Gs^Fds      , Gs^Fds      , Gg          , Gs^Fds      , Gs^Fds      , Gg          , Gs^Fds      , Gs^Fds      , Gs^Fp       , Gs^Fp       , Gs^Fp       
Wo          , Wo          , Wo          , Wo          , Wo          , Ww          , Ww          , Ww          , Ww          , Wwr         , Wwr         , Mm          , Mm          , Mm          , Mm          , Mm          , Mm          , Mm          , Chr         , Chr         , Gs^Fds      , Gs^Fds      , Ggf         , Rr          , Re          , Gs^Fds      , Gs^Fds      , Gs^Fds      , Gs^Fds      , Gg          , Gs^Fds      , Gs^Fds      , Gs^Fms      , Gs^Fms      , Gs^Fp       , Gs^Fp       , Gs^Fp       
Wo          , Wo          , Wo          , Wo          , Wo          , Wo          , Ww          , Ww          , Ww          , Wwr         , Wwr         , Mm          , Mm          , Mm          , Mm          , Mm          , Mm          , Mm          , Mm          , Gs^Fds      , Gs^Fds      , Gs^Fds      , Ggf         , Gg          , Gs^Fds      , Re          , Re          , Gs^Fds      , Re          , Gs^Fds      , Gg          , Gs^Fds      , Gs^Fms      , Gs^Fms      , Gs^Fp       , Gs^Fp       , Gs^Fp       
Wo          , Wo          , Wo          , Wo          , Wo          , Wo          , Wo          , Ww          , Ww          , Wwr         , Ww          , Wwr         , Wwr         , Mm          , Mm          , Mm          , Mm          , Mm          , Mm          , Gs^Fds      , Hh^Fds      , Ss          , Gs^Fds      , Gg          , Gg          , Gs^Fds      , Gs^Fds      , Re          , Gg^Vh       , Re          , Re          , Gs^Fds      , Gs^Fms      , Gs^Fp       , Gs^Fp       , Gs^Fp       , Gs^Fp       
Wo          , Wo          , Wo          , Wo          , Wo          , Wo          , Wo          , Ww          , Ww          , Ww          , Ww          , Ww          , Wwr         , Wwr         , Mm          , Mm          , Mm          , Mm          , Hh^Fds      , Hh          , Gs^Fds      , Ss          , Ggf         , Ggf         , Gs^Fds      , Hh^Fds      , Hh          , Hh          , Hh^Fds      , Mm          , Mm          , Re          , Re          , Gs^Fms      , Gs^Fms      , Gs^Fp       , Gs^Fms      
Wo          , Wo          , Wo          , Wo          , Wo          , Wo          , Wo          , Wo          , Wo          , Ww          , Ww          , Ww          , Ww          , Wwr         , Wwr         , Mm          , Mm          , Mm          , Gs^Fds      , Hh^Fds      , Ggf         , Ggf         , Ggf         , Gg          , Ggf         , Hh^Fds      , Gs^Fds      , Hh^Fds      , Mm          , Mm          , Mm          , Mm          , Mm          , Re          , Re          , Gs^Fms      , Gg          
Wo          , Wo          , Wo          , Wo          , Wo          , Wo          , Wo          , Wo          , Wo          , Wo          , Ww          , Ww          , Ww          , Wwr         , Ww          , Wwr         , Ww          , Gs^Fds      , Ss          , Ss          , Gs^Fds      , Gs^Fds      , Gs^Fds      , Ggf         , Gg          , Gs^Fds      , Gs^Fds      , Mm          , Mm          , Mm          , Mm          , Mm          , Mm          , Mm          , Ggf         , Re          , Re          
Wo          , Wo          , Wo          , Wo          , Wo          , Wo          , Wo          , Wo          , Wo          , Wo          , Wo          , Ww          , Ww          , Ww          , Ww          , Ww          , Ww          , Ww          , Ww          , Gs^Fds      , Hh          , Gs^Fds      , Ggf         , Gs^Fds      , Gg          , Gg          , Ce          , Ce          , 1 Ke        , Mm          , Gs^Fds      , Mm          , Mm          , Mm          , Mm          , Gs^Fp       , Gs^Fp       
Wo          , Wo          , Wo          , Wo          , Wo          , Wo          , Wo          , Wo          , Wo          , Wo          , Wo          , Wo          , Wo          , Ww          , Ww          , Ww          , Ww          , Ww          , Ww          , Gs^Fds      , Hh^Fds      , Hh^Fds      , Hh^Fds      , Ggf         , Gg          , Gg          , Ce          , Ce          , Ce          , Gg          , Gs^Fms      , Gs^Fms      , Gs^Fms      , Gs^Fp       , Gs^Fp       , Gs^Fp       , Gs^Fp       
Wo          , Wo          , Wo          , Wo          , Wo          , Wo          , Wo          , Wo          , Wo          , Wo          , Wo          , Wo          , Wo          , Wo          , Ww          , Ww          , Ww          , Ww          , Ww          , Hh          , Hh^Fds      , Hh^Fds      , Hh^Fds      , Hh^Fds      , Hh^Fds      , Gg          , Gg          , Ce          , Gg          , Re          , Re          , Re          , Gs^Fp       , Gs^Fp       , Gs^Fp       , Gs^Fp       , Gg          
Wo          , Wo          , Wo          , Wo          , Wo          , Wo          , Wo          , Wo          , Wo          , Wo          , Wo          , Wo          , Wo          , Wo          , Wo          , Ww          , Ww          , Ww          , Ww          , Ww          , Hh^Fds      , Hh          , Hh          , Hh          , Gs^Fms      , Gs^Fms      , Gs^Fms      , Gs^Fms      , Gs^Fp       , Gs^Fp       , Gs^Fp       , Gg          , Gs^Fp       , Re          , Re          , Gs^Fp       , Gg          
