border_size=1
usage=map

Ss          , Gs^Fmf      , Gs^Fms      , Gs^Fp       , Ss          , Gs^Fp       , Gs^Fp       , Gs^Fms      , Gs^Fp       , Gs^Fp       , Rr          , Gs^Fp       , Gs^Fp       , Gs^Fp       , Gs^Fp       , Gs^Fms      , Gs^Fms      , Gs^Fp       , Gs^Fms      , Gs^Fp       , Gs^Fp       , Gs^Fms      , Gs^Fms      , Gs^Fp       , Gs^Fp       , Gs^Fp       , Gs^Fp       , Gs^Fms      , Gs^Fms      , Gs^Fms      , Gs^Fp       , Gs^Fp       , Gs^Fp       , Gs^Fp       , Gs^Fp       , Gs^Fms      , Gs^Fp       , Gs^Fp       , Gs^Fms      , Gs^Fms      , Gs^Fp       , Gs^Fp       , Gs^Fms      , Gs^Fp       , Gs^Fp       , Gs^Fms      , Gs^Fp       
Gs^Fp       , Gs^Fmf      , Gs^Fp       , Gs^Fp       , Gs^Fp       , Gs^Fp       , Gs^Fmf      , Gs^Fms      , Gs^Fp       , Gs^Fp       , Rr          , Gs^Fp       , Gs^Fp       , Gs^Fp       , Gs^Fmf      , Gs^Fms      , Gs^Fp       , Gs^Fp       , Gs^Fp       , Gs^Fp       , Gs^Fp       , Gs^Fms      , Gs^Fms      , Gs^Fp       , Gs^Fp       , Gs^Fp       , Gs^Fms      , Gs^Fms      , Gs^Fdf      , Gs^Fms      , Gs^Fp       , Gs^Fp       , Gs^Fp       , Gs^Fp       , Gs^Fms      , Gs^Fms      , Gs^Fp       , Gs^Fp       , Gs^Fmf      , Gs^Fms      , Gs^Fp       , Gs^Fms      , Gs^Fms      , Gs^Fp       , Gs^Fp       , Gs^Fmf      , Gs^Fp       
Gs^Fms      , Ss          , Ss          , Gs^Fp       , Ss          , Gs^Fp       , Gs^Fp       , Gs^Fp       , Gs^Fp       , Gs^Fp       , Rr          , Gs^Fp       , Gs^Fp       , Gs^Fp       , Gs^Fp       , Gs^Fp       , Gs^Fp       , Gs^Fp       , Gs^Fms      , Gs^Fp       , Gs^Fmf      , Gs^Fp       , Gs^Fp       , Gs^Fds      , Gs^Fms      , Gs^Fms      , Gs^Fmf      , Gs^Fp       , Gs^Fp       , Gs^Fp       , Gs^Fds      , Gs^Fms      , Ggf         , Gs^Fp       , Ww          , Ggf         , Ww          , Gs^Fp       , Ggf         , Ggf         , Ggf         , Gs^Fds      , Gg          , Ggf         , Ww          , Gs^Fmf      , Ww          
Ss          , Ww          , Gs^Fp       , Gs^Fp       , Gs^Fp       , Gs^Fp       , Gs^Fp       , Gs^Fp       , Ss          , Ggf         , Gs^Fp       , Rr          , Rr          , Ggf         , Ggf         , Ggf         , Ggf         , Gs^Fms      , Gs^Fms      , Gs^Fp       , Gg          , Gs^Fms      , Gs^Fp       , Gs^Fp       , Gs^Fp       , Gs^Fp       , Gs^Fds      , Gs^Fp       , Ww          , Gs^Fp       , Ww          , Ww          , Ww          , Ww          , Ww          , Ww          , Ww          , Ww          , Ww          , Ww          , Ww          , Ww          , Ww          , Ww          , Ww          , Ww          , Ww          
Ss          , Gs^Fp       , Ss          , Gs^Fp       , Ss          , Ss          , Gs^Fp       , Gs^Fms      , Gs^Fp       , Ggf         , Gg          , Gs^Fmf      , Ggf         , Rr          , Rr          , Rr          , Rr          , Gg          , Ggf         , Gg          , Ggf         , Ggf         , Gg          , Gs^Fp       , Gs^Fp       , Gs^Fds      , Ww          , Ww          , Ww          , Ww          , Ww          , Ww          , Ww          , Ww          , Ww          , Ww          , Ww          , Ww          , Ww          , Ww          , Ww          , Ww          , Ww          , Ww          , Ww          , Ww          , Ww          
Ww          , Ww          , Ww          , Ww          , Gs^Fp       , Ss          , Ww          , Ss          , Ww          , Ww          , Ggf         , Ggf         , Gg          , Gg          , Gg          , Ggf         , Gg          , Rr          , Rr          , Ggf         , Gs^Fms      , Gs^Fmf      , Gs^Fms      , Ggf         , Ww          , Ww          , Ww          , Ww          , Ww          , Ww          , Ggf         , Ww          , Re^Gvs      , Ww          , Re^Gvs      , Gg          , Ggf         , Ggf         , Re^Gvs      , Ww          , Ww          , Ww          , Ww          , Ww          , Ss          , Ww          , Ss          
Ww          , Ww          , Ww^Vm       , Ww          , Ww          , Ss          , Chs         , Ww          , Chs         , Ww          , Gs^Fp       , Gg          , Ggf         , Gs^Fp       , Ss          , Gs^Fp       , Gg          , Ggf         , Rr          , Gg^Vh       , Ggf         , Gs^Fds      , Ggf         , Ggf         , Ww          , Ww          , Ww          , Ww          , Re^Gvs      , Ggf         , Gg          , Re^Gvs      , Re^Gvs      , Re^Gvs      , Re^Gvs      , Gg^Wm       , Re^Gvs      , Re^Gvs      , Re^Gvs      , Re^Gvs      , Ggf         , Gg          , Ss          , Ss          , Ss          , Ggf         , Gs^Fms      
Ww          , Ww          , Ww          , Ww          , Ww          , Chs         , Chs         , 3 Khs       , Chs         , Chs         , Ggf         , Ggf         , Ggf         , Gg          , Ggf         , Ggf         , Gs^Fms      , Ggf         , Gg          , Rr          , Rr          , Gg          , Ww          , Ww          , Ww          , Ww          , Ggf         , Re^Gvs      , Re^Gvs      , Re^Gvs      , Re^Gvs      , Gg^Wm       , Re          , Re^Gvs      , Ggf         , Re          , Gg          , Re^Gvs      , Ww          , Gg          , Ggf         , Ggf         , Ss          , Gs^Fp       , Ss          , Ss          , Gs^Fms      
Wo^Xo       , Wo^Xo       , Wo^Xo       , Ww          , Ww          , Ww          , Ww          , Ww          , Gs^Fms      , Gs^Fds      , Ss          , Gg          , Gg          , Gs^Fms      , Gs^Fp       , Gg          , Gs^Fp       , Ss          , Ss          , Ggf         , Gs^Fms      , Rr          , Wwf         , Ww          , Ww          , Ww          , Ggf         , Ggf         , Ggf         , Re^Gvs      , Ggf         , Re          , Gg          , Ggf         , Ggf         , Ggf         , Ww          , Ww          , Chw         , Ww          , Gg          , Gg          , Gg          , Gs^Fp       , Gs^Fp       , Gs^Fp       , Ss          
Wo          , Wo          , Wo^Xo       , Ww          , Ww          , Ww          , Ww          , Ww          , Ww          , Ss          , Ww          , Ggf         , Ww          , Ss          , Ss          , Gg          , Ggf         , Ss          , Ww          , Ww          , Ww          , Ww          , Ww          , Rr          , Rr          , Gg          , Gs^Fms      , Gs^Fmf      , Rr          , Gs^Fms      , Ggf         , Re          , Ggf         , Gg          , Ggf         , Ww          , Ww          , Chw         , 2 Khw       , Chw         , Ww          , Gg          , Gg          , Gs^Fms      , Ss          , Gs^Fp       , Gs^Fms      
Wo          , Wo          , Wo          , Wo^Xo       , Ww          , Ww          , Ww          , Ww          , Ww          , Ww          , Ww          , Ww          , Ww^Vm       , Ww          , Ww          , Ww          , Ww          , Ww          , Ww          , Ww          , Ww          , Ww          , Gs^Fms      , Ggf         , Ggf         , Rr          , Rr          , Rr          , Gs^Fms      , Rr          , Rr          , Rr          , Rr          , Gg          , Rr          , Wwf         , Ww          , Chw         , Chw         , Chw         , Ww          , Gg          , Gg          , Gs^Fp       , Gs^Fp       , Ggf         , Gs^Fp       
Wo          , Wo          , Wo          , Wo^Xo       , Wo^Xo       , Ww          , Ww          , Ww          , Ww          , Ww          , Ww          , Ww          , Ww          , Ww          , Ww          , Ww          , Ww          , Ww          , Ww          , Ww          , Ww          , Ww          , Gs^Fms      , Gs^Fp       , Gs^Fms      , Gg          , Ggf         , Gg          , Gg          , Gg^Vh       , Gg          , Ggf         , Gs^Fms      , Rr          , Rr          , Ggf         , Ww          , Ww          , Ggf         , Ww          , Ggf         , Ww          , Gg          , Gg          , Ss          , Ss          , Gs^Fp       
Wo          , Wo          , Wo          , Wo          , Wo          , Wo^Xo       , Wo^Xo       , Wo^Xo       , Wo^Xo       , Ww          , Wo^Xo       , Ww          , Wo^Xo       , Ww          , Wo^Xo       , Ww          , Ww          , Ww          , Wo^Xo       , Ww          , Ww          , Ww          , Ww          , Gs^Fms      , Ss          , Gs^Fp       , Ss          , Ggf         , Gg          , Ggf         , Gs^Fms      , Gg          , Gg          , Gs^Fp       , Gg          , Rr          , Wwf         , Ww          , Ggf         , Ggf         , Ww          , Ss          , Gg          , Gg          , Ggf         , Ggf         , Gs^Fms      
Wo          , Wo          , Wo          , Wo          , Wo          , Wo          , Wo          , Wo          , Wo          , Wo^Xo       , Wo          , Wo^Xo       , Wo          , Wo^Xo       , Wo          , Wo^Xo       , Wo^Xo       , Wo^Xo       , Wo          , Wo^Xo       , Ww          , Ww          , Ww          , Ww          , Ww          , Ww          , Ww          , Ss          , Gg          , Gs^Fmf      , Gs^Fp       , Gs^Fms      , Gg          , Ggf         , Ww          , Ww          , Gg          , Rr          , Gg          , Ww          , Ww^Vm       , Gs^Fp       , Ss          , Gg          , Gg          , Ggf         , Gg          
Wo          , Wo          , Wo          , Wo          , Wo          , Wo          , Wo          , Wo          , Wo          , Wo          , Wo          , Wo          , Wo          , Wo          , Wo          , Wo          , Wo          , Wo          , Wo          , Wo^Xo       , Wo^Xo       , Ww          , Ww          , Ww          , Ww          , Ww          , Ww          , Ww          , Ggf         , Ss          , Ww          , Ggf         , Ww          , Ww          , Gg          , Gg          , Gg          , Rr          , Ggf         , Ww          , Ggf         , Gs^Fp       , Gs^Fp       , Ss          , Ggf         , Gg          , Ggf         
Wo          , Wo          , Wo          , Wo          , Wo          , Wo          , Wo          , Wo          , Wo          , Wo          , Wo          , Wo          , Wo          , Wo          , Wo          , Wo          , Wo          , Wo          , Wo          , Wo          , Wo          , Wo^Xo       , Ww          , Ww          , Ww          , Ww          , Ww          , Ww          , Ww          , Ww          , Gs^Fms      , Ww          , Gs^Fms      , Gg          , Gg          , Gs^Fds      , Gg          , Rr          , Rr          , Gg          , Ggf         , Gs^Fp       , Ss          , Gs^Fp       , Ggf         , Ggf         , Rr          
Wo          , Wo          , Wo          , Wo          , Wo          , Wo          , Wo          , Wo          , Ww          , Ww          , Ww          , Ww          , Ww          , Wo          , Wo          , Wo          , Wo          , Wo          , Wo          , Wo          , Wo          , Wo^Xo       , Wo^Xo       , Ww          , Ww          , Ww          , Ww          , Ww          , Ww          , Ss          , Gg          , Ggf         , Ss          , Gs^Fmf      , Gg^Vh       , Gg          , Re          , Gg          , Ggf         , Rr          , Rr          , Ggf         , Gg          , Gg          , Rr          , Rr          , Ss          
Wo          , Wo          , Wo          , Wo          , Wo          , Wo          , Ww          , Ww          , Ww          , Ww          , Ww          , Ww          , Ww          , Ww          , Ww          , Wo          , Wo          , Wo          , Wo          , Wo          , Wo          , Wo          , Wo          , Wo^Xo       , Ww          , Ww          , Ww          , Ww          , Ww          , Ww          , Gs^Fmf      , Gg          , Ss          , Gs^Fms      , Gg          , Gg          , Re          , Gg          , Gg          , Gs^Fmf      , Gs^Fds      , Rr          , Rr          , Rr          , Ss          , Ss          , Gs^Fms      
Wo          , Wo          , Wo          , Wo          , Wo          , Ww          , Ww          , Ww          , Mm          , Mm          , Mm          , Mm          , Mm          , Ww          , Ww          , Ww          , Wo          , Wo          , Wo          , Wo          , Wo          , Wo          , Wo          , Wo^Xo       , Wo^Xo       , Ww          , Ww          , Ww          , Ww          , Ww          , Ww          , Ggf         , Ggf         , Ggf         , Gs^Fms      , Gg          , Gg          , Re          , Ggf         , Gs^Fds      , Ww          , Gs^Fms      , Wwf         , Ggf         , Ggf         , Gg^Vh       , Gs^Fms      
Wo          , Wo          , Wo          , Wo          , Ww          , Ww          , Ww          , Hh^Fms      , Mm          , Mm          , Rr^Vd       , Mm          , Mm          , Mm          , Ww          , Ww          , Wo          , Wo          , Wo          , Wo          , Wo          , Wo          , Wo          , Wo          , Wo          , Wo^Xo       , Ww          , Ww          , Ww          , Ww          , Ww          , Gs^Fds      , Gg          , Ss          , Gs^Fmf      , Gg          , Re          , Gg          , Ww          , Ww          , Ww          , Ww          , Ww          , Ww          , Ss          , Ggf         , Gs^Fp       
Wo          , Wo          , Wo          , Wo          , Ww          , Ww          , Ww          , Mm          , Ss          , Hh^Fmf      , Hh^Fms      , Rp          , Mm          , Hh^Fmf      , Ww          , Ww          , Wo          , Wo          , Wo          , Wo          , Wo          , Wo          , Wo          , Wo          , Wo          , Wo^Xo       , Ww          , Ww          , Ww          , Ww          , Ww          , Ww          , Ggf         , Gs^Fms      , Ss          , Gg          , Re          , Ggf         , Ww          , Ww^Vm       , Ww          , Ww          , Ww          , Ww          , Ss          , Gg          , Gs^Fms      
Wo          , Wo          , Wo          , Wo          , Wo          , Ww          , Ww          , Ww          , Ww          , Mm          , Mm          , Ww          , Ww          , Ww          , Ww          , Ww          , Wo          , Wo          , Wo          , Wo          , Wo          , Wo          , Wo          , Wo          , Wo          , Wo^Xo       , Wo^Xo       , Ww          , Ww          , Ww          , Ww          , Gs^Fmf      , Gs^Fms      , Gg          , Gs^Fms      , Gg          , Re          , Gg          , Ggf         , Ww          , Ww          , Ww          , Ss          , Ss          , Ggf         , Ggf         , Gs^Fp       
Wo          , Wo          , Wo          , Wo          , Wo          , Ww          , Ww          , Ww          , Ww          , Ww          , Ww          , Ww          , Ww          , Ww          , Ww          , Ww          , Wo          , Wo          , Wo          , Wo          , Wo          , Wo          , Wo          , Wo          , Wo          , Wo^Xo       , Ww          , Ww          , Ww          , Ww          , Ww          , Ww          , Ggf         , Gg          , Ggf         , Gg          , Gg          , Gg          , Gg          , Gg          , Gg          , Gs^Fms      , Gg          , Ggf         , Ggf         , Ss          , Ss          
Wo          , Wo          , Wo          , Wo          , Wo          , Wo          , Wo          , Ww          , Ww          , Ww          , Ww          , Ww          , Ww          , Ww          , Wo          , Wo          , Wo          , Wo          , Wo          , Wo          , Wo          , Wo          , Wo          , Wo          , Wo^Xo       , Wo^Xo       , Ww          , Ww          , Ww          , Ww          , Ww          , Ss          , Ss          , Gg          , Ggf         , Ggf         , Re          , Re          , Gg          , Ggf         , Gs^Fds      , Ggf         , Gs^Fms      , Gs^Fds      , Ss          , Ss          , Ss          
Wo          , Wo          , Wo          , Wo          , Wo          , Wo          , Wo          , Wo          , Wo          , Wo          , Wo          , Wo          , Wo          , Wo          , Wo          , Wo          , Wo          , Wo          , Wo          , Wo          , Wo^Xo       , Wo          , Wo^Xo       , Wo^Xo       , Ww          , Ww          , Ww          , Ww          , Ww          , Ww          , Ww          , Gs^Fp       , Ww          , Gs^Fp       , Gg          , Gg          , Re          , Gg          , Ggf         , Gg          , Ggf         , Gs^Fds      , Gs^Fms      , Gs^Fmf      , Gs^Fms      , Gs^Fms      , Ss          
Wo          , Wo          , Wo          , Wo          , Wo          , Wo          , Wo          , Wo          , Wo          , Wo          , Wo          , Wo          , Wo          , Wo          , Wo          , Wo          , Wo^Xo       , Wo^Xo       , Wo^Xo       , Wo^Xo       , Ww          , Wo^Xo       , Ww          , Ww          , Ww          , Ww          , Ww          , Ww          , Gs^Fms      , Ww          , Gs^Fms      , Ww          , Ggf         , Ww          , Wwf         , Re          , Gg          , Gs^Fds      , Gg^Vh       , Gs^Fds      , Gs^Fds      , Ggf         , Ggf         , Gs^Fms      , Gs^Fds      , Gs^Fms      , Gs^Fms      
Wo          , Wo          , Wo          , Wo          , Wo          , Wo          , Wo          , Wo          , Wo          , Wo          , Wo          , Wo          , Wo^Xo       , Wo          , Wo^Xo       , Wo^Xo       , Ww          , Ww          , Ww          , Ww          , Ww          , Ww          , Ww          , Ww          , Ww          , Ww          , Ww          , Ww          , Ww^Vm       , Gs^Fp       , Gs^Fms      , Ss          , Gg          , Re          , Gg          , Ww          , Ww          , Gs^Fds      , Gs^Fmf      , Ggf         , Gs^Fms      , Gs^Fds      , Ggf         , Gs^Fms      , Gs^Fds      , Gs^Fds      , Gs^Fmf      
Wo          , Wo          , Wo          , Wo          , Wo          , Wo          , Wo          , Wo          , Wo          , Wo          , Wo^Xo       , Wo^Xo       , Ww          , Wo^Xo       , Ww          , Ww          , Ww          , Ww          , Ww          , Ww          , Ww          , Ww          , Ww          , Ww          , Ww          , Ww          , Ss          , Ww          , Ww          , Ss          , Gs^Fp       , Gg          , Gg          , Re          , Gs^Fms      , Gs^Fds      , Ww          , Ss          , Ww          , Ww          , Gs^Fds      , Gs^Fds      , Ggf         , Ggf         , Gs^Fds      , Gs^Fms      , Gs^Fds      
Wo          , Wo          , Wo          , Wo          , Wo          , Wo          , Wo          , Wo          , Wo^Xo       , Wo^Xo       , Ww          , Ww          , Ww          , Ww          , Ww          , Ww          , Wwr         , Ww          , Ww          , Ww          , Ww          , Ww          , Ww          , Ww          , Gs^Fds      , Ww          , Gs^Fp       , Ss          , Ww          , Gs^Fp       , Gs^Fms      , Ggf         , Re          , Re          , Gs^Fms      , Gs^Fds      , Gs^Fds      , Ww          , Ggf         , Ww          , Ww          , Gs^Fds      , Gs^Fds      , Gg          , Ggf         , Gs^Fds      , Ggf         
Wo          , Wo          , Wo          , Wo          , Wo          , Wo          , Wo          , Wo^Xo       , Ww          , Ww          , Ww          , Ww          , Wwr         , Wwr         , Wwr         , Wwr         , Hh^Fms      , Wwr         , Hh^Fms      , Ww          , Hh^Fms      , Gs^Fds      , Hh^Fms      , Gs^Fms      , Gs^Fms      , Gs^Fms      , Gs^Fp       , Gs^Fp       , Gs^Fp       , Ggf         , Gg          , Ggf         , Re          , Gs^Fds      , Gg          , Gg          , Gg          , Gg          , Ggf         , Ww          , Ww          , Gs^Fds      , Ww          , Ggf         , Ww          , Ww          , Ww          
Wo          , Wo          , Wo          , Wo          , Wo          , Wo          , Wo^Xo       , Wo^Xo       , Ww          , Ww          , Wwr         , Wwr         , Wwr         , Wwr         , Mm          , Mm          , Mm          , Mm          , Hh^Fms      , Hh^Fms      , Hh^Fms      , Gs^Fmf      , Re^Gvs      , Gs^Fms      , Gs^Fms      , Gs^Fms      , Gs^Fp       , Gs^Fp       , Ggf         , Gg          , Re          , Ggf         , Ggf         , Gg          , Ggf         , Gg          , Gs^Fds      , Gs^Fds      , Gg          , Gg          , Ggf         , Ww          , Gg          , Wwf         , Gg          , Gg          , Ggf         
Wo          , Wo          , Wo          , Wo          , Wo          , Wo^Xo       , Ww          , Ww          , Ww          , Ww          , Wwr         , Wwr         , Mm          , Mm          , Mm          , Mm          , Gs^Fds      , Hh^Fms      , Hh^Fms      , Hh^Fms      , Re^Gvs      , Re^Gvs      , Re^Gvs      , Re^Gvs      , Re^Gvs      , Gs^Fms      , Gs^Fms      , Gs^Fp       , Gg          , Re          , Gg          , Gg          , Gs^Fp       , Gg          , Gg          , Gg          , Gs^Fmf      , Gs^Fms      , Gs^Fmf      , Gs^Fds      , Gg          , Gg          , Ggf         , Gg          , Gs^Fds      , Gg^Vh       , Gs^Fms      
Wo          , Wo          , Wo          , Wo          , Wo          , Wo^Xo       , Ww          , Ww          , Ww          , Wwr         , Wwr         , Wwr         , Hh^Fdf      , Mm          , Re          , Hh^Fms      , Gs^Fds      , Hh^Fms      , Re          , Gg^Wm       , Re          , Re^Gvs      , Re^Gvs      , Re^Gvs      , Ggf         , Gg          , Gg          , Gg          , Re          , Re          , Gs^Fds      , Gs^Fms      , Gs^Fdf      , Gg^Vh       , Gg          , Gg          , Gs^Fms      , Gs^Fdf      , Gs^Fms      , Gs^Fds      , Ggf         , Gg          , Gs^Fds      , Gs^Fds      , Gs^Fms      , Gs^Fds      , Gs^Fms      
Wo          , Wo          , Wo          , Wo          , Wo^Xo       , Wo^Xo       , Ww          , Ww          , Ww          , Wwr         , Wwr         , Mm          , Re          , Re          , Gs^Fds      , Re          , Re          , Re          , Ggf         , Re          , Re          , Ggf         , Gg^Vh       , Ggf         , Re          , Re          , Ggf         , Ggf         , Re          , Gg          , Ggf         , Gs^Fds      , Ggf         , Gs^Fds      , Ggf         , Ggf         , Gg          , Gs^Fds      , Gs^Fds      , Gg          , Ggf         , Gg          , Gs^Fms      , Gs^Fds      , Gs^Fms      , Ggf         , Gs^Fms      
Wo          , Wo          , Wo          , Wo          , Wo^Xo       , Ww          , Ww          , Ww          , Ww          , Ww^Bw\      , Ww^Bw/      , Re          , Mm          , Mm          , Mm          , Hh^Fms      , Gs^Fms      , Gs^Fds      , Re^Gvs      , Gg          , Re          , Re          , Re          , Re          , Re          , Re          , Ggf         , Gg          , Re          , Gg          , Gg          , Gg          , Gg          , Gg          , Gg          , Gg          , Ggf         , Gg          , Gg          , Gg          , Gs^Fds      , Gs^Fds      , Gs^Fds      , Gs^Fds      , Gs^Fms      , Gs^Fms      , Gs^Fms      
Wo          , Wo          , Wo          , Wo^Xo       , Ww          , Ww          , Ww          , Ww          , Wwr         , Wwr         , Mm          , Mm          , Mm          , Mm          , Hh^Fds      , Gs^Fms      , Re^Gvs      , Re^Gvs      , Re^Gvs      , Re^Gvs      , Re^Gvs      , Gg          , Re          , Gg          , Gg          , Ggf         , Gg          , Re          , Re          , Re          , Re          , Ggf         , Gg          , Gg          , Gg          , Gg          , Ce          , Gg          , Gg          , Gg          , Gs^Fms      , Gs^Fds      , Gs^Fds      , Gs^Fmf      , Gs^Fds      , Gs^Fds      , Gs^Fds      
Wo          , Wo          , Wo          , Wo^Xo       , Ww          , Ww          , Ww          , Wwr         , Wwr         , Wwr         , Mm          , Mm          , Mm          , Hh^Fmf      , Hh^Fms      , Re^Gvs      , Re^Gvs      , Re^Gvs      , Re^Gvs      , Re^Gvs      , Gg^Wm       , Ggf         , Gg          , Re          , Gs^Fds      , Ggf         , Gs^Fds      , Gg          , Ggf         , Gg          , Re          , Gg          , Gg          , Ggf         , Ggf         , Ce          , 1 Ke        , Ce          , Gg          , Ggf         , Ggf         , Gs^Fds      , Gs^Fds      , Gs^Fds      , Ggf         , Gs^Fds      , Gs^Fds      
Wo          , Wo          , Wo^Xo       , Wo^Xo       , Ww          , Ww          , Ww          , Wwr         , Wwr         , Wwr         , Mm          , Mm          , Mm          , Hh^Fms      , Hh^Fms      , Gs^Fms      , Gs^Fms      , Re^Gvs      , Gs^Fms      , Gs^Fms      , Re^Gvs      , Re^Gvs      , Re^Gvs      , Re          , Gs^Fms      , Gs^Fds      , Gs^Fds      , Gs^Fds      , Gg          , Gg          , Gg          , Ggf         , Gg          , Ggf         , Gg          , Ce          , Ce          , Ce          , Gg          , Gg          , Gs^Fds      , Gs^Fms      , Gs^Fds      , Gs^Fp       , Gs^Fds      , Gs^Fds      , Gs^Fds      
Wo          , Wo          , Wo^Xo       , Ww          , Ww          , Ww          , Ww          , Wwr         , Wwr         , Mm          , Mm          , Mm          , Hh          , Hh^Fds      , Hh^Fds      , Gs^Fds      , Gs^Fds      , Gs^Fds      , Re^Gvs      , Re^Gvs      , Re^Gvs      , Re^Gvs      , Re^Gvs      , Re^Gvs      , Gs^Fmf      , Gs^Fms      , Gs^Fds      , Gs^Fds      , Ggf         , Re          , Re          , Re          , Gg          , Gg          , Gg          , Gg          , Ggf         , Gg          , Ggf         , Gg          , Gs^Fmf      , Gs^Fms      , Gs^Fds      , Gs^Fds      , Gs^Fms      , Ggf         , Gs^Fds      
Wo          , Wo^Xo       , Ww          , Ww          , Ww          , Ww          , Wwr         , Wwr         , Wwr         , Mm          , Mm          , Mm          , Hh^Fds      , Hh^Fms      , Hh^Fds      , Gs^Fds      , Gs^Fds      , Gs^Fms      , Gs^Fds      , Re^Gvs      , Re^Gvs      , Re^Gvs      , Gs^Fds      , Gs^Fds      , Gs^Fds      , Gs^Fms      , Gg          , Ggf         , Gg          , Gg          , Re          , Re          , Gg          , Ggf         , Gg          , Gg          , Ggf         , Gg          , Gs^Fds      , Gg^Vh       , Gs^Fds      , Gs^Fds      , Gs^Fds      , Gs^Fms      , Gs^Fms      , Gs^Fds      , Gs^Fds      
Wo          , Wo^Xo       , Ww          , Ww          , Ww          , Ww          , Wwr         , Wwr         , Wwr         , Mm          , Mm          , Mm          , Hh^Fmf      , Hh^Fms      , Hh^Fds      , Gs^Fds      , Gs^Fmf      , Gs^Fds      , Gs^Fds      , Gs^Fds      , Gs^Fms      , Gs^Fds      , Gs^Fds      , Gs^Fds      , Gs^Fms      , Ggf         , Ggf         , Gg^Vh       , Re          , Re          , Re          , Gg          , Ggf         , Ggf         , Gg          , Gs^Fms      , Gs^Fds      , Gs^Fds      , Gs^Fmf      , Gs^Fds      , Gs^Fds      , Ggf         , Gs^Fds      , Gs^Fms      , Gs^Fds      , Gs^Fmf      , Gs^Fms      
Wo          , Wo^Xo       , Ww          , Ww          , Ww          , Wwr         , Wwr         , Wwr         , Mm          , Mm          , Mm          , Mm          , Mm          , Hh^Fds      , Hh^Fds      , Gs^Fds      , Gs^Fds      , Gs^Fms      , Gs^Fms      , Gs^Fds      , Gs^Fms      , Gs^Fms      , Gs^Fds      , Gs^Fms      , Gs^Fms      , Gs^Fds      , Ggf         , Gg          , Re          , Re          , Gg          , Gg          , Gs^Fds      , Gs^Fds      , Gs^Fms      , Gs^Fds      , Gs^Fms      , Gs^Fms      , Gs^Fds      , Gs^Fms      , Gs^Fms      , Gs^Fms      , Gs^Fds      , Gs^Fms      , Gs^Fds      , Gs^Fp       , Gs^Fds      
